cabccabccdababcbdb	TRUE
ccdababcbc	TRUE
acbccbcc	TRUE
accdbcb	TRUE
acbdbcdccccacabd	TRUE
adddbdcbacbacbacbaccdabdd	TRUE
cbddadbddcb	TRUE
adcddabcccbabd	TRUE
cabccdababcbdacc	TRUE
ddbcabcdccccacb	TRUE
dcccacbc	TRUE
daccdcbdddabddaddbacbd	TRUE
cbccaccbacadac	TRUE
cbabcbccddcdb	TRUE
acddacdbdbadcbdabcdbaccad	TRUE
abcadd	TRUE
cddbadacdbabcdadcdbccabdb	TRUE
acbdbcdccccacadacdbd	TRUE
cabdab	TRUE
ccddbcaddbabdacbdbdccacb	TRUE
dbacbcbdacdacc	TRUE
dcbdddabddaddbacbcb	TRUE
dbababaddadcbcccdddaccdd	TRUE
abadaccbcd	TRUE
abddbacbcbdb	TRUE
dd	TRUE
dd	TRUE
abadcccacdbab	TRUE
dddabccdbcb	TRUE
cbccccdbd	TRUE
acdadaddbdbcdbcdbdb	TRUE
ddababdcb	TRUE
acdbdabacdcbd	TRUE
dabcbdccb	TRUE
adcddcb	TRUE
cdbdad	TRUE
ddbddbccdcddcbccbd	TRUE
acdbdbabababcacdcbcab	TRUE
dccbddadbddcbcbdacdbc	TRUE
dacabccdadabadadbcdcbddbd	TRUE
daddbdbcdbcdbdccdb	TRUE
abcabccacacaddbacbdcdcabd	TRUE
cbccccdd	TRUE
adddacdddbcbaccabcabacbdb	TRUE
cddcaccddbcaddbabdacbdc	TRUE
acacdbacdbcababdaccabcb	TRUE
cbdbacadccdaccbddbccbdc	TRUE
dacddbcaddacb	TRUE
cbcabcbdbcdb	TRUE
cdacbcabdcd	TRUE
adbdccacddbdbccdccabc	TRUE
cddbcaddacac	TRUE
cabccabccdbdac	TRUE
caccbddbcccccbddbcadc	TRUE
cacbaccdcbdddb	TRUE
adbdccacddbdbccdccabac	TRUE
cdadaddbdbd	TRUE
cab	TRUE
dbdccbdbaccabcacdbadcb	TRUE
acacdbacdbcababc	TRUE
abddbabcabcccabdcd	TRUE
accabccdababcbdaccacadac	TRUE
cbd	TRUE
abadaccabcdadbcacabcd	TRUE
acbdccb	TRUE
cbdbcccccbdbdb	TRUE
dbcccdaccaccdccdbdcbacd	TRUE
dabd	TRUE
acdbdadcbddadddab	TRUE
acc	TRUE
cdacdcadbcbc	TRUE
ddbddbccdcddcbccbcad	TRUE
ddbabccbdbacabccdacbabdcd	TRUE
cbccdcddcbccbcadadbcb	TRUE
dbabdaccabcdadbcacabcd	TRUE
ddcddacdcadbcbdccbaddabd	TRUE
cdbdadcbddadddabcccbd	TRUE
addb	TRUE
addb	TRUE
cbccdcddcb	TRUE
cdadaddbdbdb	TRUE
cacdbacdbc	TRUE
dccdaccbddbcccccbddbab	TRUE
ddbaccbdaddbabcbcbddcbddc	TRUE
ccdbdbacacdcbcabcdacdcbdb	TRUE
ddbd	TRUE
c	TRUE
c	TRUE
c	TRUE
c	TRUE
c	TRUE
c	TRUE
cbabacbc	TRUE
dddabcccbd	TRUE
acccbdbd	TRUE
addbcacbc	TRUE
cabdb	TRUE
cbdbacadccc	TRUE
dabdcdd	TRUE
cdcadb	TRUE
acacbdc	TRUE
ddbdadacdbacadbacdbacddcb	TRUE
cbccdcdb	TRUE
ccacadaccdcbdddab	TRUE
cdacbcabcbdbcdccccacad	TRUE
cacabcbabdacbcbdcbdbdadbc	TRUE
accdbdbcc	TRUE
ccbacadccdaccbddbccc	TRUE
dbdadbddcbcbdacdd	TRUE
dababdbdcaddabadddacbadbc	TRUE
dbcacabcbdaccbddadbddcb	TRUE
adcddcbccbcadaddbdbcdbd	TRUE
abadccadacbacadadbdabcadd	TRUE
cbabcbacc	TRUE
cadaccdcbdddabddab	TRUE
cdcddbaccbdaddbabcbcbadb	TRUE
abcadac	TRUE
cbaccddab	TRUE
ababcacdcbcabccbabdb	TRUE
dbdadbdd	TRUE
ccccdbddcacadccbabcdcdddd	TRUE
adbadcaccddbcaddbd	TRUE
acccbabacbcb	TRUE
cdadacdbdbc	TRUE
ad	TRUE
ad	TRUE
dbdccdbad	TRUE
ccbacadccc	TRUE
cabababcacdcbcabccbabdb	TRUE
ccacadaccd	TRUE
cadaccdcbdddabdb	TRUE
cdbdadcbddab	TRUE
abdaddddbccbdadbadccbabac	TRUE
adaccaccdccdbdcbaccadacbc	TRUE
cabcbdd	TRUE
cdbacdbcababdaccabcb	TRUE
acbacdddbcabacabcccbdbcbd	TRUE
abdadcbddadddabccdb	TRUE
adcddabc	TRUE
acbccabadb	TRUE
cdacbcabcbdbcdccccacadadc	TRUE
cdcbadcacbdbadcaccdbd	TRUE
cdacbcbad	TRUE
abcd	TRUE
dabddb	TRUE
dacbadbdbaccabcacdbadcb	TRUE
cbdacbabdcacdacaccadcbdbc	TRUE
dab	TRUE
abadadcabcdbcccdac	TRUE
abacabdccddcacdcdcabacadb	TRUE
cabccabccdababcbdaccac	TRUE
dddab	TRUE
adbcb	TRUE
daddb	TRUE
adbadcaccddbcaddbabd	TRUE
ccbadcccadbadccdbcbadcacd	TRUE
cbdaccbddadbddcbcbdacdbc	TRUE
dbcadbddacaccbaddcccabccd	TRUE
accbcadaddbdbcdbd	TRUE
dcdbddbccdcddcbccbcabd	TRUE
adcddcbac	TRUE
cddbcaddacdcddb	TRUE
cabcbdaccbddadbddcb	TRUE
adab	TRUE
accdababcbc	TRUE
cacbaccdcbab	TRUE
dbadbcbdcadbadcabababdbad	TRUE
cb	TRUE
cb	TRUE
cb	TRUE
cbabacbccddcddb	TRUE
acbccddcddacdcadbcbdb	TRUE
dcacacddbadacdcbdcbcadacb	TRUE
dcccacdbacdbcab	TRUE
dbd	TRUE
dacdbdbabababc	TRUE
dbabdddccdababcbabddbcddd	TRUE
ccacadacbad	TRUE
dbdccdbdabd	TRUE
abddbabcabcccabadcb	TRUE
daccabcdadbcacabcbdaccbdd	TRUE
dacb	TRUE
ababcacdcbc	TRUE
ccabcacdabadddcddddab	TRUE
dcdbddbccdcddcbc	TRUE
cdcabddbabcabcd	TRUE
cabababcacdcbcab	TRUE
ddbcabcdccccacabd	TRUE
db	TRUE
db	TRUE
abddbabcabcccadd	TRUE
dcbdabdcccabadbdcadbdcdbd	TRUE
cbccdbabcbcb	TRUE
cabababcacdcbcabc	TRUE
abadddadcacccaccadbababdb	TRUE
cbdbccbdc	TRUE
dcbdb	TRUE
acdbacdbcabc	TRUE
acbccddcdb	TRUE
cbab	TRUE
cbabcbcbd	TRUE
dbcbdccbaddababd	TRUE
dcbacdbdadabccbcbdaddcbdb	TRUE
acdbdbabababcab	TRUE
cddbdac	TRUE
acdacddbdac	TRUE
dcdbddc	TRUE
cbccbdbdcbadccccdacdcabcb	TRUE
ddcacbcbcdbadacbdb	TRUE
accbcadaddbdbdb	TRUE
cdcadbcbdb	TRUE
dccccdacdcabcdbcccdb	TRUE
adcdb	TRUE
dabcc	TRUE
ccbddbccbdc	TRUE
abc	TRUE
abc	TRUE
abadadcabcdbcccdaccac	TRUE
cacdbacdbcababdac	TRUE
abcddbcdbdbacabccabccdbdc	TRUE
dadbabcdbdabacdcb	TRUE
accdababcbdaccacadacbad	TRUE
cdbdadcbddadddabcccbabad	TRUE
abcddbcdbdbac	TRUE
accbd	TRUE
acb	TRUE
accbadbabcdbdab	TRUE
ccbddbcccccbdbd	TRUE
cdbdadcd	TRUE
dbcddbadacbdbcddadbccadad	TRUE
cdcdd	TRUE
dbcacabcbdaccbddabcd	TRUE
cdacdcadbcc	TRUE
dcbcbadbcbabcaddcacddddcb	TRUE
cddcaccddbcaddbabdacbdbdc	TRUE
dbddcbcbdaccbacadccdacacb	TRUE
ccdcddadabacabcbcabdddbab	TRUE
ababacacdcbcabccbadbabcdd	TRUE
accabccdbdbcc	TRUE
abddbabcabcccacbababdb	TRUE
cabc	TRUE
cdbdadcbdb	TRUE
cdcddbaccbdadbacc	TRUE
cddbcdbacc	TRUE
cbccccdbddbccdcddcb	TRUE
cbaccdcbdddab	TRUE
accabccdbdac	TRUE
cbabcbcbddcbdddacbcb	TRUE
cbabcbcbddcbdddacbccccb	TRUE
dcccacdbacdbcababdaccbcd	TRUE
caccbddbcccccbddbcdbdbac	TRUE
abddbacbcbdab	TRUE
cdacdcadbcbdccbaddababd	TRUE
acdbdbabababc	TRUE
cdbdbacacdcbcabcdacdcbdb	TRUE
acdbdadcbddadddd	TRUE
cbcbcdbadacbccbdbdb	TRUE
abadaccab	TRUE
cdabadddcdddddcbcbacbccb	TRUE
dbcdadbcacabcbdac	TRUE
dbcacabcbdd	TRUE
cbddc	TRUE
cbabcb	TRUE
cbabcb	TRUE
cacbaccdcbdddabddaddbacbd	TRUE
cbccbcabababaddadcbcad	TRUE
ccbacadccdaccbdb	TRUE
acbdaccbddadbdd	TRUE
cdacbcabcbdbcdccccacb	TRUE
abcadccdacacb	TRUE
dbcbdccbaddababdd	TRUE
abcdacdb	TRUE
cbabcbccddcddacdcadbcc	TRUE
adbdccacddbdbccdccb	TRUE
cbccccdbddbccdcddcbccbcad	TRUE
acdabd	TRUE
caccbddd	TRUE
cbdbdccacddbdbccdccb	TRUE
ddbacbcbdacdacbc	TRUE
ccbacadac	TRUE
acbaccdababdbabcaddaddcac	TRUE
cadacbdbdabadacacdacdaccb	TRUE
abddbacbd	TRUE
daccabcdadbd	TRUE
cabcbdaccbdd	TRUE
adb	TRUE
adb	TRUE
adb	TRUE
dabcbabd	TRUE
cabdadbc	TRUE
dbddcbcbdadd	TRUE
accbcabd	TRUE
cbccdcddcbc	TRUE
cbabacbccddcddad	TRUE
ddbaccbdadbcc	TRUE
ddbcabcdccccd	TRUE
ddacdcddbaccbdab	TRUE
ccbdaddbabcbacc	TRUE
acccbabacbccddcddacdcadbd	TRUE
dbdadbadcbdddabcbcccddabd	TRUE
cacdbacdbcababdacab	TRUE
cbccccdbddbccdb	TRUE
cbdcbaccadacbadbdbaccabc	TRUE
cbccbcabababaddadcbcccb	TRUE
acabccdcdbdadddacdabcbacb	TRUE
abadadcabcdbcccdaccbdd	TRUE
ccacddbdbccdccabaccbabc	TRUE
ababddababd	TRUE
ccabcdadbcacabcd	TRUE
acddbcdbdbacabccabdb	TRUE
cccbddbcdbdbacab	TRUE
accabcd	TRUE
abcc	TRUE
acbdabdbadaddabcccdcbacdb	TRUE
abcdacddbd	TRUE
acdc	TRUE
dabcbdccbaddabd	TRUE
dbdbdbacaccbacaccdababccb	TRUE
abdccacadacdbabcab	TRUE
adadbabcdbdabacdcbdcd	TRUE
cddcdb	TRUE
cdacbcabcbdbcdccccacabd	TRUE
dabcbdccbaddababdccc	TRUE
cabcbdac	TRUE
dddacbcabcbdbcdcccb	TRUE
acdbc	TRUE
cbdbacadccdaccbddbc	TRUE
ddbaccabcacdabadddcddddab	TRUE
acabababaddadcbcccddd	TRUE
cacacb	TRUE
dcbdddabddaddbacbcbdacbc	TRUE
abadcccacdbacdbcab	TRUE
ddacdcddbaccbdadbcc	TRUE
accddcddacdcbc	TRUE
acbccdbabcbacc	TRUE
caccbddbcccccbdbdb	TRUE
acdadaddbdbdb	TRUE
ddbabcabcccabadcb	TRUE
acbcb	TRUE
acbcb	TRUE
abdd	TRUE
cabccabccdbdbcc	TRUE
dcabccbadbabcdbdabd	TRUE
ccbad	TRUE
cddcaccddbcaddbabdd	TRUE
acdbdadcbddadddabccdbcb	TRUE
ddbdbcdbcdbdccdbdabd	TRUE
acdbacdbc	TRUE
cabccabccdababcbc	TRUE
ddcddacc	TRUE
addaddbacbcbdacdacbc	TRUE
acacdbacdbc	TRUE
adaccabcdadbcd	TRUE
cbcb	TRUE
cbcb	TRUE
accdababcbdaccacadbad	TRUE
cdacdcadbcbdccbadbd	TRUE
cababd	TRUE
cdcbcabccbabdb	TRUE
cbddbccdcddb	TRUE
cddbdbccdccabacad	TRUE
ddbcabcdccccac	TRUE
abdbccbcadaddb	TRUE
cabdacbcbddbddbcabacbcccb	TRUE
acbdac	TRUE
cdbdadcbddabc	TRUE
cbabcbcbddcbdddacb	TRUE
ddacdcddbc	TRUE
acdadbd	TRUE
cdacdcd	TRUE
cabdadbdccdbad	TRUE
cbcacdcdabcadadabcbccaccb	TRUE
cbccccdbddbccdcdb	TRUE
acdbd	TRUE
dcddcb	TRUE
acdbab	TRUE
adcdbdcbaccadacbadbdd	TRUE
acbdaccbddbcc	TRUE
addbdbcdd	TRUE
abddababdcccacdbacdbc	TRUE
abacdcabddbabcabcccabadcb	TRUE
adcddabcb	TRUE
ababd	TRUE
ababd	TRUE
acdcabddbabcab	TRUE
acddbcdbdbac	TRUE
ccbddabcd	TRUE
acdbdad	TRUE
cbabcbcbadb	TRUE
acabababaddadcbcccdddaccb	TRUE
acbabacbccddcddad	TRUE
ccbdacbacacabcaddcbdadb	TRUE
abadaccabcb	TRUE
acbdbcdccccacadacdbabcab	TRUE
acbd	TRUE
acdadab	TRUE
abadacab	TRUE
adaccabcdadbcac	TRUE
abaddababdcb	TRUE
cbdbadcaccddbcaddbabdd	TRUE
abadcb	TRUE
ccbdddacbccd	TRUE
cbccacdd	TRUE
ddadbdacbadaddddacacbcdbd	TRUE
accadcacbcdccbcabcabadbab	TRUE
cdacc	TRUE
adadbabcdbdabacb	TRUE
cbddbcc	TRUE
abdbcabdcbdcacdacabcdcbdb	TRUE
ddacdcdd	TRUE
cabcb	TRUE
dacbdbdccacddbdbcb	TRUE
dbdbcc	TRUE
cbdaccbddadbdd	TRUE
cbccbdbdcbadccccdacdcab	TRUE
adbcac	TRUE
acdcabddbabcabcccadd	TRUE
ccbddbcccb	TRUE
cbccccdbddbccd	TRUE
cbcbdacdacbcabcbdb	TRUE
cbccdcddcbccbcadaddbdbdb	TRUE
ddbacbcbdacdacc	TRUE
cabd	TRUE
acaccbddbccc	TRUE
acdadadbcb	TRUE
dccbddadbddcbcbdaccbac	TRUE
ababddababdcccacdbacdd	TRUE
cdcadbcbdccbd	TRUE
cbdaccbacd	TRUE
abad	TRUE
ccdababcbdaccacadac	TRUE
abadacb	TRUE
cddcaccddbcadadcb	TRUE
abadadcabcdbcccdaccaccdd	TRUE
ddbaccbdaddbabcbcbdddb	TRUE
acbcbddcbdddacbd	TRUE
cc	TRUE
cc	TRUE
cc	TRUE
caccdccdbdcbaccadacd	TRUE
cabdadbdccdbdadcbddabc	TRUE
abaddababdcccacdbacdbcabc	TRUE
abadadcabcdbcccdacc	TRUE
dccbddadbddcbcbc	TRUE
acabcccacbababdcacbdbadc	TRUE
acdcabddbabcabcccabadcb	TRUE
dddabcccbabacbccddcb	TRUE
cbabdbcadadcabdbacadbdcdd	TRUE
dbabdaccabcac	TRUE
dcb	TRUE
dcb	TRUE
dcb	TRUE
ab	TRUE
ab	TRUE
ab	TRUE
ab	TRUE
cccbddbcdbdbacabccc	TRUE
cbaccdcbdddabdb	TRUE
cdacdcadbcbdccbadc	TRUE
dcdbdd	TRUE
cacabcaddcbdaccdadbccaddb	TRUE
ddababd	TRUE
acbdaccacadaccdcbddc	TRUE
cdadaddbdbcdbcdc	TRUE
cadacdbdbabababcacb	TRUE
ddbdbcdbcdbdccdbdadcbddab	TRUE
cbabacb	TRUE
dbacdbaccbcdbccccbcbacbcc	TRUE
cbccccdbddbab	TRUE
abddababdd	TRUE
accbadbabcdbdabacb	TRUE
dbcdbdbccdccabaccbcbcdbad	TRUE
cdcdccabaccbcbcdbadacbdb	TRUE
adddab	TRUE
dbdadbddcbcbdacdbc	TRUE
adcbddadddabccdbcb	TRUE
cabdadc	TRUE
caccbddbcccccbdbd	TRUE
cdcbcabccbadd	TRUE
dbdddcdccbdcbcabccababcdb	TRUE
abddbacbcbdacdacc	TRUE
accbadbabcdbdabacdcabddc	TRUE
cbcbcdbadacbccbdbdcc	TRUE
cdbdbabababcacdcbcbabd	TRUE
cdbdadcbddadddd	TRUE
adaccabcdadbcacbdc	TRUE
ccbdabdbdcaddccbcccddcabd	TRUE
abddababdccdab	TRUE
cbcbcdbadacbccbdbdcbd	TRUE
dacbccacadcccadadbdcabacb	TRUE
cbacabddab	TRUE
dbcdadbabacbacacbadabcbdd	TRUE
cbcbcbadacbccbdbdcbadd	TRUE
ccddbcccdbdbacacdcbcabd	TRUE
dcacbababdcacb	TRUE
ddacdcddbaccbdadabadb	TRUE
cbccaccbacadccc	TRUE
dc	TRUE
abab	TRUE
dbdb	TRUE
abcbbadbbbc	FALSE
bcccbbcbddddbcccaaa	FALSE
bcbddddbcccdc	FALSE
bddcbaadddabcaadacaacadaa	FALSE
adbccadabccdbcadacdabcbba	FALSE
abbcadacdcbabddddddccdad	FALSE
bbda	FALSE
dabacadbbaaabcac	FALSE
ddddccdabacbbaddd	FALSE
bcbbabadccccad	FALSE
cdacaacacccaba	FALSE
bcaaadddaacbcadadcdcb	FALSE
ababdaddaac	FALSE
ddbaaabcddad	FALSE
addaabdddaddcabbcaaaddaca	FALSE
bbcdaaabcdabdbcbbabadcca	FALSE
cbcccdcdcacabaca	FALSE
accaccaadcbdababdacaaaca	FALSE
ccabcaddaddcbbbadbcddadda	FALSE
accabdcddaddaabdddada	FALSE
aab	FALSE
dccbcacdbdba	FALSE
bcacbacbaabdcdacbcaacccbc	FALSE
ccadabccdbcadacdabcbba	FALSE
cbaadcadcaddc	FALSE
bdabdaacacc	FALSE
ccdadaadabdcdcbdbdcacaccb	FALSE
aadbdad	FALSE
ddbdabacadbbaaabcacdabdd	FALSE
badd	FALSE
aadbdaddbb	FALSE
abbcadacdcbabddddddccda	FALSE
acdcbabddddddccdaad	FALSE
caddaddcbbbadbcddadd	FALSE
addccabcaaa	FALSE
caca	FALSE
bdbadcbcdaddccadbaaaabbdd	FALSE
dccbcacdbbcbcccdcdcacadb	FALSE
bccadabccdbcadacdabcbba	FALSE
cdaaaba	FALSE
ccccadddca	FALSE
bcccba	FALSE
daaadbadbcbbdcddcaacadcd	FALSE
dcbdda	FALSE
baaabcacdabdddabbca	FALSE
dbdabacadbbaaabcacdabdd	FALSE
adbdcaa	FALSE
daadcbbcccadaacadaccabdc	FALSE
acaa	FALSE
daacdbdcdabcdcdbb	FALSE
aaabcda	FALSE
bcbbabadccccadddbdad	FALSE
bdabdaaca	FALSE
ddaaab	FALSE
aaabcddadbdabdaacabacac	FALSE
dcaaccaaacadcdbcbacadcabc	FALSE
dabdaacabadc	FALSE
acbdacadbccabbbdcdadcabda	FALSE
dbdabacadbbaaabcacdabd	FALSE
dadbadca	FALSE
abcbdbcccccbabadddaacdd	FALSE
babadccccadddbdabad	FALSE
ddbaaabcdda	FALSE
ababdacaaacccc	FALSE
dddacbdaaaadacbdbabcbdbda	FALSE
addccabcaddaa	FALSE
acaaa	FALSE
acaaa	FALSE
acacaaabdaca	FALSE
dddbcccaaa	FALSE
aaaaa	FALSE
bdacbddaccca	FALSE
bcbbabadccccaddd	FALSE
aadbdaddbbda	FALSE
dbaaabcddadbdabdaacabadc	FALSE
dcbbbadbc	FALSE
cbdddaa	FALSE
cbacadaabdbbbbcdacdaabdaa	FALSE
adbabdaacddaddccdddcbddcc	FALSE
aacdbdcdabca	FALSE
acbddacccdadbcdca	FALSE
ddadbacacaaabdcdacaadcc	FALSE
ddaadddbaaabcddadb	FALSE
dababdacaaaca	FALSE
aadbda	FALSE
cadca	FALSE
cbcccdcdcacadba	FALSE
dbbabdaadcbbcccadaacaaa	FALSE
aacdddacaabbbaabcbdbdaabc	FALSE
bbaa	FALSE
bdcacabbabddbcbdabccbdb	FALSE
aadcdcad	FALSE
baadca	FALSE
bcddaadbdaddbbdccbaddca	FALSE
aadcacbbaacddababcccbddda	FALSE
cbddddbcccaa	FALSE
ddbaaabcddadbabcd	FALSE
cbbadbbbdc	FALSE
aacccabccbcdcbddbbbaccbab	FALSE
cbaadcadcaddcbcabadbdda	FALSE
acaacacccabbaadc	FALSE
bdcdabcdc	FALSE
abacada	FALSE
ddadbacacaaabdcdacaacaca	FALSE
acadca	FALSE
bbbcdaaabcdabdbcbbabadcca	FALSE
dccabca	FALSE
ccabcadda	FALSE
cbdda	FALSE
baadcdcadbcccbbcbddddbcd	FALSE
adbcddadddaaddd	FALSE
ccdacddccbcacdbbcdba	FALSE
bcadacda	FALSE
cbaada	FALSE
cbabddddddccdabacbba	FALSE
addaa	FALSE
abcbdbcccccbabadddaacd	FALSE
aadcadcaddca	FALSE
ddbaaabcddadbdabdaacabadc	FALSE
cdcadbcccbbcbddddbcd	FALSE
ddaacbcadadcdcbdbdab	FALSE
cadbcccbbcbdddda	FALSE
cbdababdacaaaccccddaacd	FALSE
bdabacadbbaaabcacdabd	FALSE
aadbdaddbbdccbaddccabd	FALSE
acacadaacacabdabbcaaaadbc	FALSE
bbc	FALSE
bbc	FALSE
cbddacbdcdcaacadcdbccbcca	FALSE
abddbcbdabccbdbdcdaa	FALSE
aadcadcaddcbcabadbdcaabad	FALSE
ccbaddcaaa	FALSE
cbdabacada	FALSE
adbcdda	FALSE
addbbdcacdacbcbacdcaabadd	FALSE
bbcddaadbdaddbba	FALSE
bcadacdabcbbadbca	FALSE
abadccccadda	FALSE
ddca	FALSE
bbadbcddadda	FALSE
daddcbb	FALSE
baadcdcadbcccbbcbd	FALSE
adbda	FALSE
abcadddcbdbaccddadcbcbcca	FALSE
dcbca	FALSE
cdaaabcdabdbcbbabaddd	FALSE
abaa	FALSE
aadbdaddbbdccbaddcca	FALSE
dccabcaddaddcbb	FALSE
cbbbad	FALSE
dadbacadda	FALSE
cadacdcbabddddddccdabacba	FALSE
cdbbdacbddacccdadbcca	FALSE
bdcdabcdcdb	FALSE
bdacbddacccdaad	FALSE
b	FALSE
b	FALSE
b	FALSE
b	FALSE
b	FALSE
b	FALSE
dcdacddbabacdbbdbdccadbcc	FALSE
cdcacabaccbbbc	FALSE
addcadbdbacaadddbcbabcdaa	FALSE
addccabcaddaddca	FALSE
ddbdabacadbbaaa	FALSE
bbaaabcacdabdddabd	FALSE
dabbcadacdcbabddddddcc	FALSE
aadddbaaabcddadbabcd	FALSE
baadcdcadbcccbbcbdddda	FALSE
abdaacabacacbcbaaa	FALSE
bbdacbddacccda	FALSE
ccabcaddadda	FALSE
ddbcccaa	FALSE
dababdacaaaccccdad	FALSE
bbdcc	FALSE
ddbaaabc	FALSE
aacacc	FALSE
baaabcdda	FALSE
cbdababdaacd	FALSE
ddadbaaab	FALSE
aadbdaddbbdcc	FALSE
baaad	FALSE
ddadbacacaaabdcaca	FALSE
aadbdbbaaabdcadbabccbbaac	FALSE
bcda	FALSE
bcccb	FALSE
bcccb	FALSE
adaa	FALSE
adba	FALSE
cdcacabaccbbbcddaad	FALSE
aadbdaddbbdccbadda	FALSE
daaca	FALSE
dadddaadd	FALSE
acdabdacbdcddabccbdbcbbdc	FALSE
aaabcddadbdabaa	FALSE
cbaadcadcaddcbca	FALSE
adddadbacacaaabdcdaaca	FALSE
da	FALSE
da	FALSE
acacbcbaadcadca	FALSE
dbcccccbabadddaacdd	FALSE
cacdabdddabbcaa	FALSE
dddacbdaaaadacbdba	FALSE
dcaabadddadcab	FALSE
acadcaaa	FALSE
aadbdaddbbdccba	FALSE
caa	FALSE
caa	FALSE
caa	FALSE
caa	FALSE
caa	FALSE
caa	FALSE
bda	FALSE
caabaaddcddcaccbdaaadabaa	FALSE
cbaabbadaaaacccdbbaaabcac	FALSE
dcada	FALSE
ddabddaacbacaaabcdccddadc	FALSE
bcddadda	FALSE
cdabdbcbbadad	FALSE
dddabbcadacdcbabd	FALSE
aadcadcaddcbcabadbdda	FALSE
dbdabacadbcda	FALSE
abcbbadbbbcdaaabca	FALSE
cdbbdac	FALSE
dccdacddccbcacda	FALSE
daacdbdcdabca	FALSE
cbddddbccca	FALSE
badddddacbdaaaadacbdbabc	FALSE
bcccccbabadddaacd	FALSE
cccdcdcacabaccbba	FALSE
babadbadccbddddaddaaaadcd	FALSE
bcddaadbdaddbbdccbaddcca	FALSE
aaddda	FALSE
bcbddddbcccbaaa	FALSE
cbaadcadcad	FALSE
accaccaadcbdababdaaccd	FALSE
caddcbcabadbdcaaba	FALSE
dadbacaaaccca	FALSE
addcbbba	FALSE
cbdabaad	FALSE
acdabcbbadbca	FALSE
ccadabccdbca	FALSE
adddaacddbdbbabdaadcbbaba	FALSE
ddbcccbdaccaaa	FALSE
aadddbaaad	FALSE
caddaddcbbbadbcddadddaad	FALSE
cadacdabcbbadbbbcaca	FALSE
bbdccba	FALSE
cdaaca	FALSE
ddbdabacadbbaaabcacdabdda	FALSE
cbabddddddccaba	FALSE
abacbbadddddacbdaaaaad	FALSE
cca	FALSE
aadcadcaddcbcabadbdcaaba	FALSE
aaa	FALSE
dcaa	FALSE
aacacbadadcdacbabdbabbcdb	FALSE
cabadbdcaabad	FALSE
ddadbdbddbcbbddaadbacdcda	FALSE
adbccadabccdbcadaa	FALSE
adabcdaccadbaabbadadaddab	FALSE
adbdcaabadddaadc	FALSE
bddbdaddcdabdaccbdcabbddb	FALSE
baa	FALSE
bbcdba	FALSE
cdaaabcdabdd	FALSE
cacdbbcdba	FALSE
bbbcdaaabcdabdbcbbabaad	FALSE
cccbbcbd	FALSE
ccbcacdbbcbccc	FALSE
cdacaaad	FALSE
ddadbacacaaabdcdaaaba	FALSE
adbdcaabadda	FALSE
aacdbddc	FALSE
adada	FALSE
daccaccaadcbdababaadc	FALSE
cadcaddcbcabaa	FALSE
badbcddadda	FALSE
cdbbdacbaa	FALSE
ccdaacd	FALSE
cdabcdcdbbdacbddaca	FALSE
abccdbcadacdabcbbadbb	FALSE
dbcccccbabadddaacddbdbba	FALSE
addcca	FALSE
ccbcacdbbcdba	FALSE
daacdbdcdabcdc	FALSE
ccadabccdbcadada	FALSE
aacabacacbcbaa	FALSE
ccdacddccbcacdbbc	FALSE
bdccbaad	FALSE
addaaab	FALSE
dacbdaaaadacbdbad	FALSE
daacdbdcdabcdcdbbdacbddaa	FALSE
cdabcdcdbbdacbaa	FALSE
dabdaacabacac	FALSE
accaccaadcbdababaadc	FALSE
aaabcddadbdabdaacabadc	FALSE
dbaaaaaccbdcccbababaadacd	FALSE
adbabcabbabbdaacabdbadcdc	FALSE
acaacacccabcdba	FALSE
adbdaa	FALSE
adbdcaabadddadbaddc	FALSE
dcddaddaabdddaddcabbacb	FALSE
adbdcaabad	FALSE
bccadabccdbcaa	FALSE
baadcdcadbcd	FALSE
cdbbdacbddacccdadbad	FALSE
dcdabcdcdbbdacbddacccda	FALSE
acada	FALSE
acddccbda	FALSE
acadcddccdaca	FALSE
dabccaaccaaddbcddbbdcbddd	FALSE
dabadca	FALSE
aaccaadabcdccbbabacbabbad	FALSE
dcdabcdcdbbdacbdac	FALSE
addcbbbadbcddadddaaddd	FALSE
baaabcddadbdab	FALSE
baadcdcaaa	FALSE
aadba	FALSE
aacdbdcdabcdcdbbdacbaa	FALSE
cadbcccba	FALSE
abcbbadbbbcaca	FALSE
baadcdcadbccc	FALSE
cdcadbcccbbcbddddbccc	FALSE
dccdacddccbcacdbbcdba	FALSE
daa	FALSE
daa	FALSE
daa	FALSE
daddbbdccbaddccabca	FALSE
aadbdaddbba	FALSE
cadacdabcbbadbb	FALSE
ccadabccdbcadacdaba	FALSE
acddccbcacdbbcbcccdcdcaca	FALSE
ccdacddccbcacdbdba	FALSE
ca	FALSE
ca	FALSE
ca	FALSE
daddcbbbadbcddaddad	FALSE
acacbcbaa	FALSE
cdaaabcdabdbcda	FALSE
addaabdddaddcabbcaaa	FALSE
aadbdaddbbdccbaddccac	FALSE
cbcccdcaa	FALSE
dbbabdaadcbbcccaaaa	FALSE
caddaa	FALSE
acacbcbaadcadcaddca	FALSE
baadcdcadbcccbbcb	FALSE
adbccadabccdbcadacdabcba	FALSE
cbcabadbdda	FALSE
caddaddcbbbadbcdda	FALSE
bcbbabadccccadddca	FALSE
dbaaabcddadbdabdaaabc	FALSE
bbbcdaaabcdabdbcbbadad	FALSE
acddccbcacdbbcbcccdcdad	FALSE
ddddacbdaaaadacbdbad	FALSE
dadbacacaaabdcdaaaba	FALSE
babdaadcbbcccadaaaba	FALSE
bcccccbabadddaacddbd	FALSE
ccadabca	FALSE
bdbdbbadaababccdaacabaada	FALSE
bbadd	FALSE
ccbcaa	FALSE
cacabbabddbcbdabccbdaa	FALSE
cadcaddcbcadaccca	FALSE
accbbbcda	FALSE
cbcccdcdaba	FALSE
cdcadca	FALSE
aadbdadd	FALSE
daacdbdcdabcdcd	FALSE
adbcddadddaadd	FALSE
acaacaccca	FALSE
dddddccdabacbbad	FALSE
acadcddccdaa	FALSE
dbdabacadbbaaabda	FALSE
cdabdbcbbabadcccd	FALSE
badbcddadd	FALSE
cdacaadcc	FALSE
bc	FALSE
dbabaaccddadcacbacacccdca	FALSE
acadcddccdacada	FALSE
ddaaddd	FALSE
bbbcbadccbadbbcabbddcaadb	FALSE
cbbbadbcddadd	FALSE
ddadbacacaaabdc	FALSE
ccbddaacddbdcbdcbbaacdaca	FALSE
cddada	FALSE
bbdacbdac	FALSE
cbdabacaa	FALSE
baab	FALSE
adbccaadd	FALSE
cdbcadbabddaabdddcaaacaad	FALSE
caadbddacacdaacaacbcddccb	FALSE
adcdcbdbdcacabbabddbcbdaa	FALSE
aadbdaddbbdccbaad	FALSE
cbdbcccccbabadddaacdd	FALSE
cadbcccbbcbddddbcccbaaa	FALSE
bbabdaadcbbcccaaaa	FALSE
bbcbcdba	FALSE
badbbbcdaaabcdab	FALSE
cbaa	FALSE
acaacacccab	FALSE
bcbcdba	FALSE
accaccaadcbdabab	FALSE
accdbcbbcaacacddbadbbabdc	FALSE
bdacbcdbbacaabbdadbaaabcc	FALSE
cbacbcddcacaabadccdcadbcc	FALSE
ccadabcada	FALSE
cddccdacada	FALSE
accbbaa	FALSE
abdbcbbaba	FALSE
dbdcdaabadbdaaadbadbcbbdc	FALSE
ddadbacadda	FALSE
baadcdcadbcccbbcbddddbccc	FALSE
daccaaa	FALSE
caaa	FALSE
badbcddadddaaddd	FALSE
cdcadbcccbbcbd	FALSE
adbdcaaa	FALSE
adbdabadca	FALSE
daadbdaddbbdcc	FALSE
aadcadcaddcbcabadbdcaa	FALSE
aaabcddadbdabacc	FALSE
ddbcbbccabbbddacbbdadbbdd	FALSE
ccdaca	FALSE
accaccaadcb	FALSE
cdddccdbcbaddcaddcdbbcaac	FALSE
aaca	FALSE
acaacacccabbaadcdca	FALSE
dbbdcc	FALSE
acdabcbbadbb	FALSE
dddabbcacacbddccabbdbccaa	FALSE
baaabcddadbdabdaaca	FALSE
dddbcccaa	FALSE
cbbacaddaabdddaaddaccdccd	FALSE
dacbddaccaa	FALSE
dcbcabadbdcaaba	FALSE
cddccdacddccbcacdca	FALSE
acbbadddddacbdaaaadacbd	FALSE
dabbcadacdcbabdddddab	FALSE
daddaabdddaddcabbcaaaacb	FALSE
daddcbbbadbcddadddaaddd	FALSE
daaaaadadcccccdcbbbdabdda	FALSE
ddbcccbdaccaccaadc	FALSE
accbbacadc	FALSE
bccadabccdbca	FALSE
bcba	FALSE
daacdbdcdabcdcdbbdacbdac	FALSE
aadcdcadbcd	FALSE
cbdababdacaaaccccab	FALSE
bdcacabbabddbcbdabccbdaa	FALSE
badbbbcdaaabcdabdbc	FALSE
bcdba	FALSE
cbdababdacaaacccc	FALSE
cadcadada	FALSE
dccdacddca	FALSE
bacadcddccdacd	FALSE
baaabcacdabdddabbcaa	FALSE
bbcddbcbddadabdcdbcbddcdc	FALSE
dddbcccbdaccaccaa	FALSE
bdacbddacccda	FALSE
cadcaddcbcabadbdcaaa	FALSE
abadcdcbddabbcdcdaddcdaaa	FALSE
abdddabbcadacdcd	FALSE
abccdbcadaa	FALSE
bdaddbbda	FALSE
acdcbabddddddccaba	FALSE
cdaabadbdaaadbadbcbbdcd	FALSE
accabdcddaddaabdddaddd	FALSE
dadbacacaaabdcdacaacaccca	FALSE
dbb	FALSE
bdad	FALSE
cbdbcccccbabaddada	FALSE
aadddbaaabcda	FALSE
bb	FALSE
bbdacbaa	FALSE
dbbabdaadcbbcccadaaca	FALSE
bddaadaddbbddbbcddaccdbcd	FALSE
daddcbbbadbcddadddaad	FALSE
babdbdbcabbcdccbaddadbdba	FALSE
cbdababdacaaaca	FALSE
bdbbabdaadcbbccca	FALSE
ddacbdaaaadacbdbabc	FALSE
ccdacddccbcacdbbcbcdba	FALSE
accbbbcddaadbdaddbbdccbad	FALSE
addcbbbadbcddadda	FALSE
aabcddcccbcbaaccbadabaabc	FALSE
addccabcaddaab	FALSE
caaadddaacbcadadcdcbdb	FALSE
acaaaccccddaacdb	FALSE
adddddacbdaaaadacbdba	FALSE
aacdabadddcccdcdccccccdbc	FALSE
aca	FALSE
aca	FALSE
daccaccaadcbdababdacaaaca	FALSE
bdbbabdaadcbbcccadaaca	FALSE
bdcacabbabddbcbdabccb	FALSE
cada	FALSE
aaabcadccdccccbcbcdcacbbc	FALSE
dadbaaab	FALSE
