cacaddcccbacaddd	TRUE
ccdddddbb	TRUE
badbdbddbbbcdbabadc	TRUE
ccddcdcaabca	TRUE
cbdbaccadbddccaacbdb	TRUE
dadddcadcdbcacadaa	TRUE
bccacbcdd	TRUE
cddcdcaba	TRUE
badcbaaaacdcadaccdad	TRUE
bdbaccadbddccaacbdb	TRUE
dcdbd	TRUE
cbbdbb	TRUE
cb	TRUE
cb	TRUE
cb	TRUE
cb	TRUE
cb	TRUE
acbcb	TRUE
dcaaabadbddccdc	TRUE
cdadbc	TRUE
bdbcdccaadbcaaab	TRUE
cab	TRUE
adcbbcacdada	TRUE
addbaaaadcdaadabb	TRUE
aacacc	TRUE
cadbccacdabbdcbab	TRUE
ccccdaddb	TRUE
baa	TRUE
bbaabcad	TRUE
addbaa	TRUE
dca	TRUE
adb	TRUE
cadbcbaacacb	TRUE
daaabdcddbaccdabdbca	TRUE
bacadbbcbc	TRUE
adbacaaabcbabcacbbb	TRUE
dba	TRUE
aadcdaadba	TRUE
aacacca	TRUE
dbbcbcacdbcd	TRUE
badcadbcadb	TRUE
bccacbccdd	TRUE
bbdccbdbabdabaccd	TRUE
baacacb	TRUE
addcccbac	TRUE
aacb	TRUE
ddcdcaaabadbdd	TRUE
dcacbcdcdcccc	TRUE
ccaba	TRUE
babdb	TRUE
daadabaccccabaa	TRUE
cccbdadaccdddddbb	TRUE
d	TRUE
d	TRUE
d	TRUE
d	TRUE
d	TRUE
d	TRUE
d	TRUE
d	TRUE
d	TRUE
d	TRUE
d	TRUE
d	TRUE
d	TRUE
d	TRUE
d	TRUE
d	TRUE
d	TRUE
d	TRUE
d	TRUE
d	TRUE
d	TRUE
d	TRUE
d	TRUE
d	TRUE
d	TRUE
d	TRUE
bbdbdddcad	TRUE
adcbbcacdadaad	TRUE
bcaddbdaddbdabb	TRUE
ccccdaddbabacbcdb	TRUE
bdabdccdbacbcdb	TRUE
dcdcdcdbcaadba	TRUE
cacbccddcdcdbdc	TRUE
dabaccccabaa	TRUE
aadbaaddbdacc	TRUE
addbdaddbdabdb	TRUE
ddbaaaadcdaadabb	TRUE
acacccbd	TRUE
bcddbbadcdcdd	TRUE
dcdcdbcaadbaaddbd	TRUE
aaadcda	TRUE
cbcdcdcccccdadb	TRUE
addbaaaadcdba	TRUE
dadaadabacc	TRUE
bcbccd	TRUE
bdbbdddddb	TRUE
cccbd	TRUE
dddabadddadadcbddcdb	TRUE
aabdbbdddddcbcdab	TRUE
ccbdccbbbcaddbcbbb	TRUE
cacbcb	TRUE
ccccab	TRUE
cacbccddcda	TRUE
dbddacdaaabdcddbaaa	TRUE
dabaabbdbdddcbacada	TRUE
bca	TRUE
cadbcbaacac	TRUE
ddcccdcbdbcbcdccbaab	TRUE
cbcdcd	TRUE
daaddaadbbacddababd	TRUE
babdabccacbcdd	TRUE
cdaddbbcaa	TRUE
cccb	TRUE
ba	TRUE
adacaabbdcdddbcdbcac	TRUE
cbdabdccdbacbcdad	TRUE
baccccabaaaacb	TRUE
cdada	TRUE
babdabcc	TRUE
cdb	TRUE
dbcccbaaaababdcbba	TRUE
bacb	TRUE
dcbb	TRUE
badcadbcad	TRUE
babcaacacccbd	TRUE
baadbadbcccbaaaababd	TRUE
bbb	TRUE
ccabaa	TRUE
adacaabbdcdddbcdbca	TRUE
baacacaddcccbacab	TRUE
adabaccc	TRUE
aaadcdaadabb	TRUE
bccacbccddcda	TRUE
baadbdadccddddb	TRUE
babdab	TRUE
dddabadddadadcbddcb	TRUE
dabac	TRUE
daccbdccbbbcaddbcbb	TRUE
cdbacbcdb	TRUE
bcdadaad	TRUE
ccdaddbb	TRUE
dadcbcaddbdaddbad	TRUE
abaaaacb	TRUE
caddbaaaadcdba	TRUE
bcdadaadcbbcacd	TRUE
bcbbdccbdbabdaba	TRUE
ccbacadddbcb	TRUE
adabacaab	TRUE
cdbbccbdabddddacdd	TRUE
acc	TRUE
dcaaab	TRUE
cababccadccaabcdbbba	TRUE
aaaccbabca	TRUE
ddacadddbdddabaadb	TRUE
adabacadbbcbcacdb	TRUE
dadadcbcaddbdadb	TRUE
abadcbaaaacdcadadb	TRUE
dddaacdcaabcbaccbc	TRUE
aaccbab	TRUE
accbabcaacac	TRUE
acaddccd	TRUE
cdcaabcbaccbcadaddd	TRUE
ccdddddbcbabdab	TRUE
acbbdbdddcadccadb	TRUE
ddcdcdbdccab	TRUE
dabbabd	TRUE
cdbccbdabdcca	TRUE
bbbbbccdcdbaacacbbda	TRUE
aaccbabca	TRUE
bbdbdddcb	TRUE
dcbdbcbcdccbacdddbb	TRUE
accbabcaacaccdd	TRUE
da	TRUE
da	TRUE
dcbbcacdadaad	TRUE
addbaaaadcdaadb	TRUE
adbaaddbdac	TRUE
caadbcaaacbabbcda	TRUE
abadcbaaaacdcadaccd	TRUE
bcacdbccbdabdcca	TRUE
adccadb	TRUE
cbd	TRUE
dccc	TRUE
dbddacdaaabdcddbac	TRUE
cbcdcdcccccd	TRUE
cacb	TRUE
dcdbdc	TRUE
badddadadcbddcddbb	TRUE
a	TRUE
a	TRUE
a	TRUE
a	TRUE
a	TRUE
a	TRUE
a	TRUE
a	TRUE
a	TRUE
a	TRUE
a	TRUE
a	TRUE
a	TRUE
a	TRUE
a	TRUE
a	TRUE
a	TRUE
a	TRUE
a	TRUE
a	TRUE
a	TRUE
a	TRUE
a	TRUE
a	TRUE
a	TRUE
a	TRUE
a	TRUE
a	TRUE
a	TRUE
a	TRUE
ccccddbdbdb	TRUE
bcddbbadcdcdcdbc	TRUE
ddbdaccccccaab	TRUE
cdac	TRUE
aadbcaaacbabbcd	TRUE
adddaaabdbbddb	TRUE
abca	TRUE
dcbbcacdadaadabac	TRUE
bccddcd	TRUE
daccdddddbcbb	TRUE
caddb	TRUE
daddbabacbcdb	TRUE
adbcbaaca	TRUE
cbccddcd	TRUE
dadddcadcdbcacadaaaa	TRUE
baacacaddcccbac	TRUE
cdadaad	TRUE
bcddcbadcadbac	TRUE
acdb	TRUE
bacbcdada	TRUE
aa	TRUE
aa	TRUE
dcaaabadbddccdcbd	TRUE
bcaddbdaddbad	TRUE
ddbabacbcdad	TRUE
cbacadddabadb	TRUE
cbdadaccdddb	TRUE
dcbbcacdadaadaba	TRUE
badaacbdbaccadbddc	TRUE
adabbaabcad	TRUE
cccccddbdbdddad	TRUE
dcaabca	TRUE
acbcdcdccc	TRUE
ccabaaaaccbabcaac	TRUE
bccacbccddcdcdbdc	TRUE
acdbccbdb	TRUE
cbcda	TRUE
adbaaddbdaccccab	TRUE
addbaaaadcd	TRUE
cdbdbaabcdcddacaddbd	TRUE
dcbaadbdadccbb	TRUE
cccabaaaaccbabca	TRUE
dada	TRUE
caa	TRUE
bad	TRUE
adcbbc	TRUE
acac	TRUE
ab	TRUE
ab	TRUE
cbcdb	TRUE
dcdcdcdbc	TRUE
dddaabbbb	TRUE
cacccbdad	TRUE
cddcd	TRUE
ddaadbbacddababdcd	TRUE
bacadbbcbcacdbc	TRUE
adcdba	TRUE
bdab	TRUE
cdcacbcdcdcccc	TRUE
cddcdcaaababc	TRUE
cbdb	TRUE
aabca	TRUE
cdcdbaacacbdbdbcddb	TRUE
baabbdbdddcbacadadba	TRUE
aaadd	TRUE
cbdabdccdba	TRUE
cbcdad	TRUE
cdab	TRUE
cdab	TRUE
dcdcdcdbcaaa	TRUE
bc	TRUE
bcbcccdd	TRUE
cabaaaaccbb	TRUE
cdbbdccdccadbbccbcdb	TRUE
cbcdcdcc	TRUE
dccaadbcaaacbb	TRUE
cbcdcdc	TRUE
acacccbdada	TRUE
ddcbadcadbac	TRUE
ccc	TRUE
cdbbccbdabddddacdaa	TRUE
dbabddcabdbdbdccaddb	TRUE
dddbadcccdbdbaabcd	TRUE
acb	TRUE
cbcd	TRUE
dbbccbdabddddacddcbb	TRUE
cadbcbaa	TRUE
cdddddbcbb	TRUE
dccbd	TRUE
cdaddbabacbcdada	TRUE
ddba	TRUE
daba	TRUE
cccddbdbdddad	TRUE
bdccdbacbcddbb	TRUE
abbdbdddcbacadadba	TRUE
dddaaabdbbddddd	TRUE
cddcdcaabca	TRUE
ddaadbbacddababdcdac	TRUE
baacacaddcccba	TRUE
cbcbccd	TRUE
ddbdaccccdab	TRUE
baccccb	TRUE
dcccdbdbaabcdcddaab	TRUE
bbcacdad	TRUE
abdbbdddddb	TRUE
db	TRUE
db	TRUE
dabaccccb	TRUE
baadbadbcccbaaabcda	TRUE
dad	TRUE
cbcdadaadba	TRUE
ac	TRUE
dcaaabba	TRUE
dcbbc	TRUE
babdabccacbc	TRUE
ccbacab	TRUE
bcddbbadcbc	TRUE
cbcdcdcccab	TRUE
dcbbbbbccdcdbaabdb	TRUE
acbbdbdddcadccb	TRUE
dcbaadbdadccddaa	TRUE
daccdab	TRUE
acacccbdadacdb	TRUE
aabadbddccdcaacc	TRUE
cdddddbcbbb	TRUE
dbbdccdccadbbccbcdb	TRUE
dabaccccab	TRUE
bcaac	TRUE
aaccb	TRUE
ccccccddbdbddddad	TRUE
aca	TRUE
bdabcca	TRUE
aabbcbb	TRUE
dddddb	TRUE
badcadbcadabacab	TRUE
dbcbaacacaddc	TRUE
dbdadccdddddbbaac	TRUE
cddb	TRUE
bbacdddaacdcaabcbacb	TRUE
cbbdbdddcadccb	TRUE
abadbddccd	TRUE
dbacaaabcbabcacbbdbb	TRUE
ddcccbacada	TRUE
aacbcddadabdddabca	TRUE
cacccbdada	TRUE
addbdaddbdbd	TRUE
dddbabccdbbdccdacb	TRUE
cccdadb	TRUE
bcdadbc	TRUE
acbbdbdddcadccab	TRUE
cdd	TRUE
cdd	TRUE
bdccbbbcaddbcbcbbbbc	TRUE
cdbccbdabd	TRUE
cba	TRUE
dcdbdccada	TRUE
caadbcaaacbbd	TRUE
baccccabaaaac	TRUE
dbdccab	TRUE
aadcdaad	TRUE
adabacadbbcbc	TRUE
adddbadb	TRUE
acddcccdcbdbcbcdcd	TRUE
bdadac	TRUE
dabdbcaadbabddcbcc	TRUE
dbdccada	TRUE
dacdb	TRUE
daddbabacbcdad	TRUE
cbbdbdddcadcc	TRUE
caddbabaa	TRUE
dcbbcacdb	TRUE
dbddca	TRUE
ccadbccacdabbdcb	TRUE
dacaabbdcdddbcdbca	TRUE
cacccbdadaccdddb	TRUE
bdccdbacbcdb	TRUE
dbabddcabdbdbdccadb	TRUE
cc	TRUE
cc	TRUE
cadbcbaaca	TRUE
dcacbcdcd	TRUE
babdabccacbccdac	TRUE
cccab	TRUE
b	TRUE
b	TRUE
b	TRUE
b	TRUE
b	TRUE
b	TRUE
b	TRUE
b	TRUE
b	TRUE
b	TRUE
b	TRUE
b	TRUE
b	TRUE
b	TRUE
b	TRUE
b	TRUE
b	TRUE
b	TRUE
b	TRUE
b	TRUE
b	TRUE
b	TRUE
b	TRUE
b	TRUE
b	TRUE
b	TRUE
b	TRUE
b	TRUE
b	TRUE
b	TRUE
b	TRUE
b	TRUE
b	TRUE
b	TRUE
b	TRUE
b	TRUE
b	TRUE
b	TRUE
b	TRUE
b	TRUE
b	TRUE
b	TRUE
b	TRUE
b	TRUE
b	TRUE
b	TRUE
b	TRUE
b	TRUE
b	TRUE
b	TRUE
b	TRUE
b	TRUE
b	TRUE
b	TRUE
b	TRUE
b	TRUE
b	TRUE
b	TRUE
b	TRUE
b	TRUE
b	TRUE
b	TRUE
b	TRUE
b	TRUE
b	TRUE
b	TRUE
b	TRUE
b	TRUE
b	TRUE
b	TRUE
b	TRUE
b	TRUE
b	TRUE
b	TRUE
b	TRUE
b	TRUE
b	TRUE
b	TRUE
b	TRUE
b	TRUE
b	TRUE
b	TRUE
b	TRUE
adbbcbcacdb	TRUE
adabacab	TRUE
accbab	TRUE
dcdcdcdbcaadbba	TRUE
bcccddcdca	TRUE
aabdbbdddddcbcdd	TRUE
addcccbaaa	TRUE
dc	TRUE
acbbdbdddcad	TRUE
bcddcbadcadbcad	TRUE
dbbcbcacdbccbd	TRUE
cdbacbcdad	TRUE
daccdddb	TRUE
adcdbcacadaaaacddcc	TRUE
bcddacccadbaccaddcaaaaaaa	FALSE
bdcddaaaaaaa	FALSE
dacacacaaaaaaa	FALSE
accddcdaabadbaccbdaaaaaaa	FALSE
cbddcadbdddabadaaaaaaaa	FALSE
cabbdccaaaccccdcbdaaaaaaa	FALSE
caddcaccccbccacbdcaaaaaaa	FALSE
caabaaaaaaa	FALSE
dadcbaddddbcbadaaaaaaa	FALSE
ddabadabdbaacaaaaaaaa	FALSE
bacacdbddbacaddbddaaaaaaa	FALSE
aacddbabbacbcbdddbbbbbbbb	FALSE
aaaabcbbdaaaaaaaa	FALSE
aadadbdbdabcdaaaaaaaa	FALSE
dbdcaaaaaaa	FALSE
badaaddaadaaaaaaaa	FALSE
babbdccbcbdaadcdacaaaaaaa	FALSE
cbdccadbaabdcbacaaaaaaaad	FALSE
cbdcbacaadadcbcdbaaaaaaaa	FALSE
bacbbaaabdcdbabaaaaaaa	FALSE
dbcdbcbadbbbddbbacaaaaaaa	FALSE
abcbccdbdcccaccadaaaaaaa	FALSE
cbbddabcaaadbcdacaaaaaaa	FALSE
daacacccbadbdcdcaaaaaaa	FALSE
abcabcccdadcccdaaaaaaaa	FALSE
dddcddccddabbddbbdaaaaaaa	FALSE
bcaacbbcbbbbbbbba	FALSE
bbaabbbddacbdaaaaaaaabdca	FALSE
daacaccabaaaaaaa	FALSE
ccaacddbacadadbabcaaaaaaa	FALSE
bbdcacaaaaaaa	FALSE
ddbbddacabbdadacbbbbbbbba	FALSE
ccdababcdbccaaabacaaaaaaa	FALSE
ababcacbbbbdaabdccaaaaaaa	FALSE
bdcaabbababaaaaaaaa	FALSE
dbabadcbccdbcccaaaaaaaaca	FALSE
dcddddaaaaaaa	FALSE
daacbcccabcabaaaaaaa	FALSE
cddbacadbbdddaaaaaaa	FALSE
aaaabbcaabbacdacaaaaaaa	FALSE
abacbbaaaaadbbbbcbaaaaaaa	FALSE
acbaaaaaaa	FALSE
ddadacbaadbcabbbbbbbb	FALSE
dabbacbbaaccbdbadaaaaaaaa	FALSE
addbaaadddbdcdadbbbbbbbbc	FALSE
adababadcacbcbacaaaaaaaab	FALSE
bddddcdabbabbbaabaaaaaaaa	FALSE
dadaaaaaaa	FALSE
adbdbdcaaaacdccabcaaaaaaa	FALSE
bcdcdaddaaaaaaaaa	FALSE
baccccdadbbacccbadaaaaaaa	FALSE
caabbabaaaaaaaac	FALSE
babaaaaaaaac	FALSE
ccdcdacccdabddcaaaaaaaa	FALSE
daacbccaaaaaaa	FALSE
cabdbdaaaaaaa	FALSE
bdbacaaaaaaaac	FALSE
baaaaaaa	FALSE
baaaaaaa	FALSE
baaaaaaa	FALSE
baaaaaaa	FALSE
ddaaaaaaaa	FALSE
ddaaaaaaaa	FALSE
caadbccdaaaaaaa	FALSE
aaaabcbbdddcaabddaaaaaaa	FALSE
aaabbdcabcaabdaabaaaaaaaa	FALSE
cdacaaaaaaaad	FALSE
acbdacdacbaaaaaaaa	FALSE
bdcdbadcaaaaaaaaa	FALSE
dbdbacacabcccabcaaaaaaa	FALSE
bbddadcadacaadbddaaaaaaaa	FALSE
bcaaaaaaa	FALSE
bcaaaaaaa	FALSE
dbddbcbabddcaacdadaaaaaaa	FALSE
abbdcbbddabaaaaaaa	FALSE
ddcadbdddadaaaaaaaa	FALSE
bdccaaaaaaa	FALSE
cabdcbcacdccdabdcaaaaaaaa	FALSE
bdaccbdabdcbdcbddbbbbbbbb	FALSE
dbdbadaaaaaaa	FALSE
abadbbabdcdcccbdaaaaaaa	FALSE
ccbadcdaaaaaaa	FALSE
bbdcaccbbddbabcaaaaaaaaa	FALSE
dadcbaddddbcbdcdaaaaaaa	FALSE
dadacbccacbbbccaaaaaaaaba	FALSE
abcbccddbcdadaaaaaaaa	FALSE
dcccacccdaddaaaaaaa	FALSE
abaaaaaaaaa	FALSE
abadadbddaccaaddbaaaaaaaa	FALSE
bacbaaaccdaccbaaaaaaaacdd	FALSE
dbccbbbcbacababcbbaaaaaaa	FALSE
aaabaaaaaaaa	FALSE
bcdaaacbbdcaaaaaaa	FALSE
caccdbcaaaaaaaa	FALSE
abaddadccbaaddcaaaaaaa	FALSE
bcaacbcdbbbdabbaabaaaaaaa	FALSE
dbdcbdbbabcdbdcddbbbbbbbb	FALSE
badbaaaaaaa	FALSE
bcaabbacdaccccdbabaaaaaaa	FALSE
bacbbaaadbbbbbbbbb	FALSE
bdbacacabcccabcadcaaaaaaa	FALSE
dcaadbccdadacbcaaaaaaaa	FALSE
dbacacabaaaaaaa	FALSE
cabcccdadaaaaaaaa	FALSE
bcababddadadcdcbcdaaaaaaa	FALSE
abcbccdbdcccadaaaaaaa	FALSE
bdcddddaaaaaaaa	FALSE
cddddbccbbbcbacaaaaaaaa	FALSE
dcaadbccdadacbcdbaaaaaaa	FALSE
bddbabccaaaaaaa	FALSE
daacaccaaaaaaa	FALSE
cdbccaaabddacadaaaaaaa	FALSE
ddbccbbbcbacaaaaaaaada	FALSE
ccabcdbdbbabbbbaadaaaaaaa	FALSE
dbadaaddaaaaaaaab	FALSE
dadcbaaaaaaaaa	FALSE
aaaaaaaaab	FALSE
bdaaaaaaa	FALSE
bbbdcccbbadbbccdbdaaaaaaa	FALSE
caaacdabaadabcacaaaaaaaad	FALSE
adacbaaaaaaa	FALSE
badcadaaaaaaaa	FALSE
dcaaaaaaa	FALSE
abdcdcccaaaaaaa	FALSE
adbbabdcdcccbdcbcaaaaaaa	FALSE
cabcdcbbaccccdaaaaaaa	FALSE
cbaaaaaaaaa	FALSE
cbbddabcaaadbcdacbaaaaaaa	FALSE
dddbccbbbbbbbb	FALSE
ccddcaadbcdbabaaaaaaa	FALSE
bcdaaaaaaaaa	FALSE
cadaaaddddcdcbcdabaaaaaaa	FALSE
dcddddbccbbbaaaaaaaa	FALSE
bcabcaabaaabdaccdaaaaaaaa	FALSE
bdaabbcacaddbbccbaaaaaaaa	FALSE
caccbaaaaaaa	FALSE
bbdcdddcbcbddaccddaaaaaaa	FALSE
cdbbacbcbbaaaaaaa	FALSE
bcbaabbacbdadaaaaaaaa	FALSE
abddcdbddaacbcaaaaaaa	FALSE
addddadacbaadbcccdaaaaaaa	FALSE
bcadaaccdaaaccacddaaaaaaa	FALSE
acacacbbdcccadcbbbaaaaaaa	FALSE
cddaabcddbcbaaddabaaaaaaa	FALSE
abddcaabaaaaaaa	FALSE
cdcccbbbbbbbb	FALSE
dabcaaadaaaaaaaa	FALSE
cbcabdbdcddaaaaaaaa	FALSE
bbadaaaaaaaa	FALSE
cbdaaaaaaa	FALSE
bdbadaaaaaaa	FALSE
acccccccdaaaaaaaac	FALSE
addacdacdbcdacaadbaaaaaaa	FALSE
cabdacaadbccbacaaaaaaaada	FALSE
bacacabcaaaaaaaad	FALSE
dddabadabdbaaaaaaaab	FALSE
cadaaaaaaa	FALSE
dbdbdbacbcbcabacddaaaaaaa	FALSE
adbcadaaaddddcaaaaaaaa	FALSE
cdaaaaaaaa	FALSE
dbcabaaabcdacddcdbbbbbbbb	FALSE
cbadbcbbcccdcbaadbbbbbbbb	FALSE
ddcccabacaacccabbaaaaaaaa	FALSE
abcaaaaaaaa	FALSE
bcccadabbcaacbbcaaaaaaa	FALSE
aacadbbabdabbdaccdaaaaaaa	FALSE
cabbdadabbdcbbddaaaaaaa	FALSE
caaddaacdacddbcabbbbbbbba	FALSE
cbbcdcdcbaabdbdbadaaaaaaa	FALSE
dbabccdcdaaaaaaaad	FALSE
abacdbcdaaacbaaaaaaaaa	FALSE
bdddcaabddadbacaaaaaaa	FALSE
dddbbbbdadabbcbdbbaaaaaaa	FALSE
cacaddabcdcaaaaaaa	FALSE
cbcaacbbdcdccacddbaaaaaaa	FALSE
dcadbdaaaaaaa	FALSE
bdcdbbbacbdaaccccbbbbbbbb	FALSE
dbddbccbbbdcaacbbcaaaaaaa	FALSE
cddbacadaaaaaaa	FALSE
dadacbaadbcaaaaaaa	FALSE
bbaaaaaaa	FALSE
bbaaaaaaa	FALSE
cdbbcdcdaddaaaaaaaaa	FALSE
dacbccadbbcdacabddaaaaaaa	FALSE
dcaaaaddabcccddbcbaaaaaaa	FALSE
ddbccbbbcbacabadbaaaaaaa	FALSE
ddcdbddaaaaaaaaba	FALSE
bacddcbddadcccabddaaaaaaa	FALSE
ccaaaaaaa	FALSE
cdcbdddaacbabdbaacaaaaaaa	FALSE
cdccbbddbaadaaaaaaa	FALSE
cbddaaaaaaaa	FALSE
bccbadcddbaaaaaaaad	FALSE
caaaaaaaaa	FALSE
babcabcccdadcadaaaaaaa	FALSE
cbddabadbbabbbbbbbb	FALSE
dddbddacddbcacccdaaaaaaaa	FALSE
dacacacbbdcccadcbbbbbbbb	FALSE
adddcdaaadaaaaaaa	FALSE
adadbabbcacadaaaaaaaa	FALSE
abbdcbbddabcaaaaaaaac	FALSE
bcdaaacbbdcdcaccbaaaaaaa	FALSE
bacacababaaaaaaa	FALSE
ddaaddcdbdbccbcbabbbbbbbb	FALSE
cdccbdcbdcaabdadaaaaaaaac	FALSE
dbacacabcccabcadcaaaaaaa	FALSE
abdabcbdaccdddabdbaaaaaaa	FALSE
caccdbcdddacbabbbbbbbb	FALSE
addddadacbaadbccaaaaaaa	FALSE
ccadcddaaaaaaa	FALSE
bdbcccdbbbddbcaaaaaaaabba	FALSE
babaccbbabcbcbacaaaaaaaad	FALSE
adacbaadbaaaaaaa	FALSE
bcaacbbaaaaaaa	FALSE
addabbababbdcaadaaaaaaaab	FALSE
bcbbdcaabbabcaaaaaaa	FALSE
cacaccaaabcadadcbbbbbbbb	FALSE
acccdabdaaaaaaaa	FALSE
adbbabdcdcccbbbbbbbb	FALSE
cbbbaadaaaaaaa	FALSE
bccbbbcbacabaaaaaaaaa	FALSE
dacbcddaaaaaaa	FALSE
aadacccdbbadddcdaaaaaaaad	FALSE
babdacabaacddcaabdaaaaaaa	FALSE
abacdbcdaaacbbbbbbbbc	FALSE
cbbbcacadaaaaaaa	FALSE
bdddaaaaaaa	FALSE
bbbbbbbd	FALSE
bdcccadcbbbcadaaaaaaaa	FALSE
aaaaaaaaad	FALSE
aaaaaaaaad	FALSE
aaaaabbcbcadaaaaaaaa	FALSE
bcdaaaaaaa	FALSE
daddabbdddaaacdbbbaaaaaaa	FALSE
ddabdaaabbbdbcdcaaaaaaaaa	FALSE
adcddbacadbbdcacaaaaaaa	FALSE
abddcdbddaacbcccabaaaaaaa	FALSE
caabddadbcdadaaaaaaa	FALSE
daaaaaaa	FALSE
daaaaaaa	FALSE
daaaaaaa	FALSE
ccdcdaaaaaaaa	FALSE
aaaaaaaa	FALSE
aaaaaaaa	FALSE
aaaaaaaa	FALSE
aaaaaaaa	FALSE
aaaaaaaa	FALSE
aaaaaaaa	FALSE
aaaaaaaa	FALSE
abcbccdaaaaaaaa	FALSE
dcbcabdbaaaaaaaa	FALSE
bccbbbcbadaaaaaaa	FALSE
cdacccdabddcaaaaaaa	FALSE
addddadacbaaaaaaaad	FALSE
badcacaccaaaaaaaadc	FALSE
bbabdcdcccbdcbcaaaaaaa	FALSE
cbaddddbcbdcdbbcacaaaaaaa	FALSE
bcdbccccbdddccdcbcaaaaaaa	FALSE
cdbddaaaaaaaa	FALSE
cccabcabdbdaaaaaaaa	FALSE
abcbbadbaaaaaaaa	FALSE
abcbccdbddaaaaaaa	FALSE
bbcdacabdaddaaaaaaa	FALSE
caddacbacccdbbbaabbbbbbbb	FALSE
aaacbddccbdaadaaaaaaaaaaa	FALSE
ddcdaaacaadaaaaaaa	FALSE
ccdababcdbccaaaaaaaaa	FALSE
dccababaaaaaaaaa	FALSE
bcaabbacdacccaaaaaaa	FALSE
acccccccdadabcdaaaaaaa	FALSE
abddcdbddaacbccaaaaaaa	FALSE
adbcdccbbddbadaaaaaaaaa	FALSE
aaaaaaaaba	FALSE
dbbbbccbccddaadcddaaaaaaa	FALSE
dacacacbbdcaaaaaaa	FALSE
cabcacbccabbbcaabaaaaaaaa	FALSE
aadbdabbbbacbaaacdaaaaaaa	FALSE
cbaaaaabbcaaaaaaaa	FALSE
cbddcadbdddabadabaaaaaaaa	FALSE
adacbaaaaaaaadb	FALSE
adcddaaaaaaa	FALSE
bdcbbddabaaaaaaaa	FALSE
ddcadacaaaaaaaa	FALSE
abcabccaaaaaaaa	FALSE
dccddcaadbaaaaaaa	FALSE
acababcbbadaaaaaaa	FALSE
babaddccdababcdaaaaaaaaa	FALSE
aadcabcababcdababaaaaaaaa	FALSE
acabddcadaccbbbbbbbb	FALSE
bcdddaaaaaaaa	FALSE
ddcaabddadbcdccbbdaaaaaaa	FALSE
bcbddaaaaaaaa	FALSE
ddabadbbaaaaaaaa	FALSE
adcbccdabcbdbbdbdaaaaaaaa	FALSE
dcaccbbddaaaaaaa	FALSE
babcabcccdadcccdaaaaaaaa	FALSE
acabaaaaaaaaa	FALSE
bcbdcdbbcdcaaaaaaaa	FALSE
adaddbbdaacdbddcacaaaaaaa	FALSE
bacbbaaabdccaaaaaaaa	FALSE
bdbcacbddcacbaadacaaaaaaa	FALSE
bcaacbbcbadaaaaaaa	FALSE
aaacbbdcdcaaaaaaaaa	FALSE
dcadaaaaaaa	FALSE
aaaabbacaaaaaaa	FALSE
dccaaaaaaaa	FALSE
ddcaabddadbaaaaaaa	FALSE
dacbdcdccdcddddbaaaaaaaaa	FALSE
bdbddbdcdcbbbaccbdaaaaaaa	FALSE
bcacaaaaaaa	FALSE
daaaaaaaa	FALSE
bcaacbbcaaaaaaa	FALSE
baaaaaaaaad	FALSE
bccdbaaaaaaa	FALSE
bacbbaaaaaaaaba	FALSE
dacdacbaaaabcbbbbbbbb	FALSE
abbdcbaaaaaaa	FALSE
dccaaabccbaabaadbdaaaaaaa	FALSE
adbbabaaaaaaaa	FALSE
bbdbbacbcccccadacbbbbbbbb	FALSE
caabdabdbdddcccbbaaaaaaaa	FALSE
aaaaaaaaa	FALSE
aaaaaaaaa	FALSE
aaaaaaaaa	FALSE
abddcaaaaaaa	FALSE
adaadabbcbabccdabbaaaaaaa	FALSE
cccddbcadabddccacbaaaaaaa	FALSE
ccdbdcccacccdaddaaaaaaa	FALSE
bababaaaaaaaa	FALSE
ddaaaaaaa	FALSE
ddaaaaaaa	FALSE
dbaacaaaaaaaa	FALSE
bdbaaadccbbcbaaadcaaaaaaa	FALSE
bcbaadddaabadaaaaaaaaa	FALSE
bcddbaabcddacdadddaaaaaaa	FALSE
aaaaaaaabca	FALSE
dadcbaddaaaaaaaada	FALSE
cbbddabcaaadbcaaaaaaaa	FALSE
bbbaddacbbbacaacdaaaaaaaa	FALSE
badbcadaaaddddaaaaaaa	FALSE
dbcbadaaaaaaa	FALSE
babcabcccdadcaaaaaaaa	FALSE
cadcaccdbcddaaaaaaa	FALSE
ccadaaaaaaa	FALSE
caabbacaaaaaaa	FALSE
caccccbdabababbacbaaaaaaa	FALSE
bdddabadabaaaaaaa	FALSE
babcabdaaaaaaa	FALSE
cbacaaaaaaaa	FALSE
bbbbbbba	FALSE
bbbbbbba	FALSE
bbbbbbba	FALSE
badbcccadabbaaaaaaa	FALSE
cbbddabaaaaaaaa	FALSE
daaaaaaaaba	FALSE
dabadabdbaacadcabbbbbbbb	FALSE
acbcbdcdabacdbcabaaaaaaaa	FALSE
adacbbdddbdaabdadcaaaaaaa	FALSE
bcbaaaaabbaaaaaaa	FALSE
addaaaaaaa	FALSE
bdcdbadcacacdaaaaaaa	FALSE
dadbacbdcadcaccbaaaaaaaaa	FALSE
adaaaaaaa	FALSE
adaaaaaaa	FALSE
adaaaaaaa	FALSE
abbcaacbbcbbdcaabcaaaaaaa	FALSE
adbbabdcddaaaaaaa	FALSE
acdacaaaaaaa	FALSE
aaaabcbbdddcaaaaaaa	FALSE
adbaaaaaaa	FALSE
cbddbbcdcabdbdbbabaaaaaaa	FALSE
dcadbddadaaaaaaa	FALSE
baddaaddacccbbcadbaaaaaaa	FALSE
cdadbabddacaaccbadaaaaaaa	FALSE
bacdacccdaaaaaaa	FALSE
cbccdbdcccacccdaddaaaaaaa	FALSE
addbbbdacbbbbdbdcbaaaaaaa	FALSE
dadaaaaaaaa	FALSE
dadaaaaaaaa	FALSE
bcbdcbdbddbbcccaaaaaaaaaa	FALSE
adbbabdcdcccbdcbcaaaaaaaa	FALSE
dcaccbbbbbbbbc	FALSE
cabbbbbbbb	FALSE
dbdacabbdcbabbabdaaaaaaaa	FALSE
cdaaacabadbabadaaaaaaa	FALSE
dabadbbabdcaaaaaaa	FALSE
bcdadbabddacaaccdaaaaaaa	FALSE
dbdaaddcadaababbccaaaaaaa	FALSE
dcadbdddaaaaaaa	FALSE
cdacbdacdacbaaaaaaaadad	FALSE
cccabaaaaaaa	FALSE
cccabaaaaaaa	FALSE
bcdbccccccddcbaadaaaaaaaa	FALSE
dddddcbcdacdcccbdcaaaaaaa	FALSE
aaabdaaccacbcdbccbbbbbbbb	FALSE
abcbbadaaaaaaa	FALSE
bdcccadcbbbcaaaaaaaa	FALSE
acbdacdacbaaaaaaaadd	FALSE
dccabbaddbbaabcdcaaaaaaaa	FALSE
ddadbcdccbbdaaaaaaaad	FALSE
bbcbaaaaaaa	FALSE
dcdcdcdaaccdbaddadaaaaaaa	FALSE
bdbbabcccabacbccaaaaaaaac	FALSE
bbbbbbb	FALSE
bbbbbbb	FALSE
bbbbbbb	FALSE
bbbbbbb	FALSE
bbbbbbb	FALSE
bbbbbbb	FALSE
bbbbbbb	FALSE
bbbbbbb	FALSE
bbbbbbb	FALSE
bbbbbbb	FALSE
bbbbbbb	FALSE
bbbbbbb	FALSE
bbbbbbb	FALSE
bbbbbbb	FALSE
bbbbbbb	FALSE
bbbbbbb	FALSE
bbbbbbb	FALSE
bbbbbbb	FALSE
bbbbbbb	FALSE
bbbbbbb	FALSE
bbbbbbb	FALSE
bbbbbbb	FALSE
bbbbbbb	FALSE
bbbbbbb	FALSE
bbbbbbb	FALSE
bbbbbbb	FALSE
bbbbbbb	FALSE
bbbbbbb	FALSE
bbbbbbb	FALSE
bbbbbbb	FALSE
bbbbbbb	FALSE
bbbbbbb	FALSE
bbbbbbb	FALSE
bbbbbbb	FALSE
bbbbbbb	FALSE
bbbbbbb	FALSE
bbbbbbb	FALSE
bbbbbbb	FALSE
bbbbbbb	FALSE
abcdacbcbdcdaaaaaaa	FALSE
aacadcabbbbbbbb	FALSE
cdcccaaaaaaa	FALSE
aaaabcbbbbbbbbb	FALSE
bdacddccddbbdbbddaaaaaaaa	FALSE
adacbcdbbaaaaaaa	FALSE
bdcaaaaaaaaa	FALSE
bddcbdbdacadbcdcbaaaaaaaa	FALSE
adbacdcaddaabdcaacaaaaaaa	FALSE
bdcccaccaaaaaaaa	FALSE
adccbaadcbddacdaadaaaaaaa	FALSE
cccddcccbcbabddcbcaaaaaaa	FALSE
abaaaaaaaa	FALSE
abaaaaaaaa	FALSE
acabddcaaaaaaaaa	FALSE
ddabaaaacbabdcdaadaaaaaaa	FALSE
cabaaaaaaa	FALSE
cccdcdcbaccbaaaaaaaa	FALSE
cdacdbaadbdabbcaacaaaaaaa	FALSE
ddaaaaaaaad	FALSE
adacbaadbcccddbaaaaaaa	FALSE
bddbadaaddaadaccdaaaaaaa	FALSE
accbdacacacbbdcaaaaaaaa	FALSE
bdadcbaddddbdcaaaaaaa	FALSE
ccdbdcccaccadaaaaaaa	FALSE
babaddccdaacaaaaaaa	FALSE
bcdddacbcddaaaaaaa	FALSE
cbaccbccadcddccdaaaaaaaaa	FALSE
caccdbcdddacbaaaaaaa	FALSE
dacbccadbbcdacabdaaaaaaa	FALSE
aaaabbcaabbacdacdaaaaaaa	FALSE
cbadcdacabbdbdddabbbbbbbb	FALSE
cbaaccaacddaaccacdaaaaaaa	FALSE
bccdaaaaaaaaab	FALSE
cccacbbccbbdbbbccdaaaaaaa	FALSE
ddbabcbcccddbabadaaaaaaaa	FALSE
dbdadcbaaaaaaaaa	FALSE
cabdbdcddddaaaaaaa	FALSE
acaaaaaaa	FALSE
cbbdddcaaaaaaaac	FALSE
baaaaaaaa	FALSE
baaaaaaaa	FALSE
bcdddaaaaaaa	FALSE
bcbdacdabacaabadaaaaaaaab	FALSE
bcdcdaddaacacccbaaaaaaaa	FALSE
adabbdcbbddabaaaaaaa	FALSE
dbdbdbbbaacaaaccbdaaaaaaa	FALSE
cdddacbccadbbcdaaaaaaaa	FALSE
bccbadaaaaaaa	FALSE
accccdbcdcaaaaaaa	FALSE
dcadbdddabadabaaaaaaaa	FALSE
babaadbbdaadccdbbaaaaaaaa	FALSE
abcbcaaaaaaaa	FALSE
cabbdaaaaaaaa	FALSE
addcbacdaddbaacaaaaaaaaab	FALSE
baddddadadaaaaaaa	FALSE
bdbcdbadacdcdbdacdaaaaaaa	FALSE
cdacccdaaaaaaa	FALSE
