dabbbcccddcdababcacaaacda	TRUE
dbbabbccccbbccdbcbcbddbbc	TRUE
cccbbccdbcbac	TRUE
bcdaaddaabcababaaaddcdca	TRUE
dbbbdbabaddcbabaabcda	TRUE
cabab	TRUE
bbcaa	TRUE
bbacaabab	TRUE
cddacbabdcdbdbbbabcabbd	TRUE
bcddabdbbd	TRUE
addadddcbbbcbdacdbdaa	TRUE
ccdbcaddadddbb	TRUE
ddcccbbbddabbcabbccc	TRUE
accbadaacaccadba	TRUE
bbda	TRUE
baaaccacdcccddacdaaca	TRUE
cadbacdaaccbcbdcdcdcadc	TRUE
bcbdcdcdcadcacdcada	TRUE
cdaaccbcbdcdcd	TRUE
bbcbc	TRUE
cbbbddabbcabb	TRUE
dddcbbbcbda	TRUE
bcdcddcccbbbddabbcabbc	TRUE
bdbbb	TRUE
bd	TRUE
bd	TRUE
addabbcabaabbbdaac	TRUE
ddccadb	TRUE
ddbccdbabaadbbcacadddbdb	TRUE
dbab	TRUE
bcbddbbccaabbbdaabaabbb	TRUE
cabaaaccacdcccddacdaab	TRUE
adacacbcdcb	TRUE
acabcddacbb	TRUE
cdbcaddab	TRUE
dabdccdcccbbbcabcadbddb	TRUE
bb	TRUE
bb	TRUE
bb	TRUE
bb	TRUE
bb	TRUE
baddadcddd	TRUE
aaadacccdabbaabdbab	TRUE
bdb	TRUE
bdb	TRUE
bcd	TRUE
baaababbdabdcacbb	TRUE
cdcccddacdaaccdbc	TRUE
cdcadaadcbcacadaadabcbb	TRUE
ccddacdaaccdbcaddab	TRUE
cacccdabbaabdadad	TRUE
cdaaccbcbdcdcdcadcab	TRUE
bbaabdacdbdacbaaabaaacaca	TRUE
dbbabb	TRUE
babdadcccabaaaccacdc	TRUE
bba	TRUE
bba	TRUE
dbababdadcccab	TRUE
cccbbc	TRUE
cdbcbcbdac	TRUE
adcacdcadaadcb	TRUE
baaadcd	TRUE
aabddcbbbacdabaa	TRUE
dbbabbccccbbcdb	TRUE
bdccdcccbbbcabcadbddbabb	TRUE
ccaddbaab	TRUE
abbd	TRUE
caabbbdaabaabaabddbabaab	TRUE
bddcbbbacdab	TRUE
abcddacbaddadcdddabcdcddc	TRUE
bdbabdcdbbabb	TRUE
cbbbda	TRUE
cdcadaadcbcacad	TRUE
bbcdb	TRUE
bcadbdabd	TRUE
cbbbcabcadbddbabdbb	TRUE
bbcbdcdcbabbc	TRUE
cabcddab	TRUE
aacddbbbaccdadaccddacb	TRUE
acdcadaadcbcacad	TRUE
aabcddabdbddb	TRUE
dbddbabb	TRUE
bddabcab	TRUE
addadddcbbbcbdaa	TRUE
cbbbddabbcabbcccab	TRUE
abbdabdcacbddabccdbababd	TRUE
cb	TRUE
cadbacdaaccbcbdcdcdcb	TRUE
bbcaacabcddacbaddadcddaa	TRUE
bbcbdcdcbaab	TRUE
aabaabaabddbabaaababbd	TRUE
bbadb	TRUE
baaabaaacacacbcd	TRUE
aabaabaabddbab	TRUE
dabadd	TRUE
abbc	TRUE
dcbaaacbdd	TRUE
bac	TRUE
bdadcccabaaaccacdcccdda	TRUE
ccbb	TRUE
dbcbac	TRUE
cbbbcabc	TRUE
bbcbdcd	TRUE
aaabbdabdca	TRUE
bdcdbdbbbabcabbdababbb	TRUE
ccbbbddabbcabbcccaddbaa	TRUE
adb	TRUE
bbaabdcacbddabcb	TRUE
cbaddadcdddabcdca	TRUE
dbababdadcccabaab	TRUE
bcbddbbccaab	TRUE
aabbbdaabaabaabddbabaabbd	TRUE
acab	TRUE
dbcaddadddcbbbcbdacdbd	TRUE
dbbabbccc	TRUE
bcadbddbabdbabdcdbbb	TRUE
caa	TRUE
cdbabaadbbcacadddbdbcdbbd	TRUE
cdcccddacdaaccdb	TRUE
ddccbbbdacabca	TRUE
cdaaccbcbdcdcdcadcacdcad	TRUE
cbadd	TRUE
abcacdcccddacdaaca	TRUE
baddadcdddabcdcddc	TRUE
aadabd	TRUE
cdaaccbcbdcdb	TRUE
baaabaaacacacbcdccdbbbdc	TRUE
abbbdaabaabbb	TRUE
baabcdccbbdaacbacadcbbbd	TRUE
cdcccdda	TRUE
bcdcabbacbbcdcbcadcccddbb	TRUE
baddccbbbdacabcdd	TRUE
abddcbdbabdaaccbb	TRUE
badaacaccadbacdaaccbcbdcd	TRUE
ddccbcabb	TRUE
ddab	TRUE
acbddabccbad	TRUE
ccada	TRUE
ccdbcaddaddba	TRUE
bbcbdb	TRUE
bbabaaddabbcabaabbbdaac	TRUE
dacacbcdccdbbbdcabdd	TRUE
abbccaa	TRUE
bbaabdacdbdacbaaabaa	TRUE
accbcbdcdcdcadc	TRUE
aabcddabdbdadcb	TRUE
baaaccacd	TRUE
ccbbccdbcbcbddbbccaab	TRUE
daaccdbcaddaddd	TRUE
cdccb	TRUE
ddccbbbdacab	TRUE
abbcccab	TRUE
cbb	TRUE
acaaacacacbcdcb	TRUE
aaaddddc	TRUE
ddadddcbbbda	TRUE
adbddbabdbabdcdbbabbc	TRUE
cddbbbaccdadaccddaababbb	TRUE
dcddd	TRUE
babdadcccabaaaccacd	TRUE
abcdadcb	TRUE
bbacdbbca	TRUE
bbcaacabcddacbbd	TRUE
dbababdadcccb	TRUE
dcadcacdcadaadcbc	TRUE
cabddcbdbabdaaccbadaaca	TRUE
dcba	TRUE
dbddbabdbabdcdbbb	TRUE
cdcccbbbcabab	TRUE
dabcbbabcaaaccacccdabb	TRUE
bddabccdb	TRUE
dcadcacdcadaadcbcacadaabb	TRUE
abbcccaddbaaacabdca	TRUE
caccadbacdaaccbdd	TRUE
ab	TRUE
dcbcacadaadabcbbab	TRUE
dbbb	TRUE
baaabaaacacab	TRUE
baddccbbb	TRUE
caabbbdaabaabbb	TRUE
abcdda	TRUE
bbc	TRUE
bbc	TRUE
bbc	TRUE
ddbddcadacacddcdbdcbbaabc	TRUE
ddccbbbdacabcdd	TRUE
cddacdaaca	TRUE
bcadbb	TRUE
bbcbcabacccccbbcbabcccadb	TRUE
dbbabbcccb	TRUE
bdbabd	TRUE
bddcbdbabdaaccbadaaca	TRUE
bbacccbbccdb	TRUE
acaaacacacbcdccdbbbdc	TRUE
dcbbbcaaddabbcababacc	TRUE
db	TRUE
dbddbbb	TRUE
ccddacdaacca	TRUE
bbaabdacdbdacba	TRUE
ddcccbbbddabbcb	TRUE
bcadbddbabdbabdcdbbabb	TRUE
dcddcddddccdaccdcdacdcdab	TRUE
bccdbababdadccc	TRUE
ddaabcababaaaddcdcbcd	TRUE
dabdccdccdab	TRUE
bdbabdaaccbadaacaccb	TRUE
aacddbbbaccdadaccddacbabd	TRUE
bbaabdacdbdacbaaaba	TRUE
aabbdabdcacbddabccdb	TRUE
accadaaadabaaadabcabdcdbb	TRUE
baddcbabaabcdaaddab	TRUE
baabbb	TRUE
dbbabbccccbbccdbbca	TRUE
dab	TRUE
cbadaacaccadbacdaad	TRUE
aaabbdabdcacbddabccdbab	TRUE
abaabbb	TRUE
daaccdbcaddadddcbbbcbda	TRUE
abbabcbadcabdcbcddddacaac	TRUE
bcddabdbddbbdb	TRUE
aabbbdab	TRUE
cdcaddadacbacbcaabcdcbbcc	TRUE
abbcccaddb	TRUE
bbcbdcdcbaaacbdddc	TRUE
abcddabdbddb	TRUE
bdbddbabbbcdcdcbabbc	TRUE
cadcdcbcaacaddabcccccddbb	TRUE
cbbbddabbcabbcccaddbaaacb	TRUE
dbababdadc	TRUE
aaabbdb	TRUE
dbbabbc	TRUE
baabaabddbabaaab	TRUE
dadcaadacccbdbadaabbbcadc	TRUE
dcdddabcd	TRUE
caaaccddaabcdcccddbbaabdc	TRUE
daccddacbabdcdbdbbbab	TRUE
dcdddabcdca	TRUE
bcaaaccacccdabbaabdad	TRUE
acbddab	TRUE
ccaddb	TRUE
acbcdccdbbbaab	TRUE
ccabaaaccacd	TRUE
dbbabbccccbbcb	TRUE
adacacbcdccdbbbdbaa	TRUE
baddad	TRUE
dcccabaaaccacdcccddacdaa	TRUE
addadddcbbbcbdacaa	TRUE
acbddabccdbababdadccc	TRUE
dbbbdcabddcbb	TRUE
cdbcaddadddcbbbcbdacdbda	TRUE
cabcdda	TRUE
cabddcbdbabdaad	TRUE
dcbcacadaadabcbbabc	TRUE
cbadaacaccadbacdaa	TRUE
cadaadabcbbabcaab	TRUE
adba	TRUE
bbacaabaabaabddbaba	TRUE
cbbbcababd	TRUE
abdadadcbbbcaaddabbcab	TRUE
baddadcdddabcd	TRUE
aaabbdabdcaab	TRUE
bcdcddcccbbbddabbcabb	TRUE
aabaabaabddb	TRUE
bdbddbabbbcdcdcbaaadcd	TRUE
dcdccddaccbdabbdbdbdcddca	TRUE
bbcaacabcddacbaddadcb	TRUE
cdcccdd	TRUE
aaabbdabdcacbdd	TRUE
ddacbaddadcb	TRUE
cbbb	TRUE
acbddabccdbababdadcccabaa	TRUE
accbadaacaccb	TRUE
cbcbdcdcdcadcacdcb	TRUE
dcbaaacbddcbbbacdabaa	TRUE
cbaddadcdddabcd	TRUE
abbb	TRUE
bdcacbddabccdbababdadc	TRUE
acddbcdcdbcbdbdccbdaabdba	TRUE
aabddcbbbacdabaddccbbbd	TRUE
cabaaaccaa	TRUE
bbaccaddbaaacb	TRUE
bcdcddcccbbbddbb	TRUE
aabddcbbbacdab	TRUE
bbacc	TRUE
bdbabdcdbbabbccccbbccdb	TRUE
ddabdbddbabbbcdcdcb	TRUE
cccbbccdbcbcbddbbc	TRUE
daaccdbc	TRUE
dbbabbcccbb	TRUE
ccaddbaaacabdccd	TRUE
bcacdcccdda	TRUE
bdbb	TRUE
ddadddcbbbcbdacaa	TRUE
cbbbddabbcb	TRUE
aabbbdaabaabaabddb	TRUE
bcbddbbccaabbb	TRUE
cdbdacbaad	TRUE
acabcddab	TRUE
cabcddacbaddadcdddabcdb	TRUE
bcdaaddaabcababaaadd	TRUE
baabcdaaddaabcababaaaddcd	TRUE
dcacdcadaadcb	TRUE
abcababaaaddcdcaacdacdb	TRUE
bddbabaaab	TRUE
bddabccdbab	TRUE
bababdababaabcdccbbdaad	TRUE
cabaaacc	TRUE
acaaacacacbcdccba	TRUE
ccddacdaa	TRUE
aabddb	TRUE
c	TRUE
c	TRUE
c	TRUE
c	TRUE
c	TRUE
c	TRUE
c	TRUE
bbaabdcaab	TRUE
aad	TRUE
bcdcddcbbb	TRUE
addabbcabaabbbdaaccaaddcb	TRUE
abcacdcccddad	TRUE
aaabbdba	TRUE
aabaabaabddbabaaabbbc	TRUE
aaadddcbbbacdabaddccbbbda	TRUE
abaabbbdaaccadbbbdb	TRUE
abbdabdca	TRUE
aaadddcbbbacdab	TRUE
ccbbbcabcadbdabd	TRUE
dcdddabb	TRUE
bdadcccabaa	TRUE
ccbbbddb	TRUE
aaadddcbbbacdabaddc	TRUE
dcb	TRUE
abbbdaabab	TRUE
aabb	TRUE
aaaccacccdabbaabbb	TRUE
ccaddbaaacabdca	TRUE
aaabbbaabdcaab	TRUE
ccbbcdb	TRUE
adbddbabdbbb	TRUE
dbbca	TRUE
caabbbdaabaabaabb	TRUE
abcddabdbddbbcdb	TRUE
abcd	TRUE
caddbaaacabdccdcccbbbc	TRUE
cccbbccdbcbcbddbbcca	TRUE
baaababbdabd	TRUE
babdadcccabaaacc	TRUE
abb	TRUE
abb	TRUE
cbadaacaccadbacdaaccba	TRUE
cbbccbbc	TRUE
cdcccbbbcab	TRUE
ccaddbaaacabdccdccdab	TRUE
bcabb	TRUE
bcabb	TRUE
bcacdcccddacdaaccdbcaddab	TRUE
ccaddbaaacabd	TRUE
adabd	TRUE
adcbcacadaadabcbbabcaaac	TRUE
adbddbabdbabdcdbbb	TRUE
adabcbbabcaaacca	TRUE
aabcacdcccddad	TRUE
bcdca	TRUE
dba	TRUE
aaabbdabdcacbddabcb	TRUE
a	TRUE
a	TRUE
a	TRUE
a	TRUE
a	TRUE
a	TRUE
a	TRUE
a	TRUE
a	TRUE
a	TRUE
a	TRUE
a	TRUE
a	TRUE
bccdbababdadcccaba	TRUE
dcbaaadcd	TRUE
bc	TRUE
bc	TRUE
dabdccdcccbbbcabc	TRUE
baddcda	TRUE
dbbc	TRUE
bcdccdbbbaab	TRUE
acaaacacacbcdccbba	TRUE
cdcccbbbcababd	TRUE
accadbbbdbabaddcbaba	TRUE
abbbdaaccadbbbdbabaddb	TRUE
dcdcadcacdcadaadcbcacb	TRUE
acccdabbaabdadadcbbbcbab	TRUE
babdadccc	TRUE
bcdccbbdaacbacadcbbbdaddb	TRUE
baddccbbbdacabcddacbbd	TRUE
baaaccacdcccdda	TRUE
bddcbdbabdaaccbadaacaccb	TRUE
dbbabbccccbbccdb	TRUE
bcbddbbccaabbbda	TRUE
bbcaacabcddacbaddad	TRUE
bbcbdcdcbaaacbddcbbbacbc	TRUE
ccbbbcb	TRUE
bbacaabaabaabddbabaa	TRUE
cdccad	TRUE
baddaab	TRUE
ddc	TRUE
bbabaaddabbcabaabbbd	TRUE
ad	TRUE
ad	TRUE
cbaaabaaacacacbcdccbba	TRUE
cdbdacbaaabaad	TRUE
aadabdccdc	TRUE
abdbcaadacbbacbbbdadacbbd	TRUE
dddabb	TRUE
baabddbb	TRUE
dabaddca	TRUE
abcdd	TRUE
cdcccbbbc	TRUE
bcbddbbccba	TRUE
cdcccbbbcabcadbddbabdbabd	TRUE
aabddbccbbb	TRUE
adbddbabdbb	TRUE
abbbdaaccadbbbdbabaddcbb	TRUE
dbbcaabbd	TRUE
cada	TRUE
ddcccbbbddabbc	TRUE
adbbbdbabaddcbabbb	TRUE
cbcabb	TRUE
aadabdccdcccbbbcab	TRUE
dcaa	TRUE
d	TRUE
d	TRUE
d	TRUE
d	TRUE
d	TRUE
d	TRUE
d	TRUE
d	TRUE
d	TRUE
abbcccaddbaa	TRUE
cabaabddaabdcbddbdcadbcba	TRUE
bcddabdbddbabbbcd	TRUE
dabdccd	TRUE
dd	TRUE
dd	TRUE
dd	TRUE
aaadacccdabbaabdadad	TRUE
badaacaccadbacd	TRUE
dbbabbcc	TRUE
dbdbbbabcabbdabababdababa	TRUE
daadcbcacadaadabcbbb	TRUE
ccaddbaaacb	TRUE
aabdd	TRUE
bcdccdbbbdcabddcbdbabdaad	TRUE
dabaddccbbbdacabca	TRUE
ddbaaacabdccdcccbbbc	TRUE
dbdacbaaaba	TRUE
abbbda	TRUE
cddacdaaccdbcaddaddd	TRUE
baaabaaacaca	TRUE
baabaabddbb	TRUE
aaadacccdabbaabdadadcbbbc	TRUE
addaddddbd	TRUE
dbbabbccccbbccdbcbcbddbb	TRUE
cccbbccdbcbcbddbbccaab	TRUE
bbcccdabaa	TRUE
cdbabbd	TRUE
bbcaacabcddacbaddaab	TRUE
dbbadb	TRUE
bcdaaddaabcababaaaddcd	TRUE
dbcbdabbdddcdbbadababccbd	TRUE
cccbbccdbcbcbddbb	TRUE
cbbbddabbcabbccaa	TRUE
baaababbdabdcacbdd	TRUE
aa	TRUE
dcdddabcdcddc	TRUE
cbbbcabcadbdabd	TRUE
bcdcddccaabb	TRUE
dcbaaacbddcbbbacd	TRUE
bbcaacabca	TRUE
daaccbcbdcdcdcad	TRUE
badd	TRUE
cdcadaadcbcacadaadaba	TRUE
bbcaacabcddab	TRUE
cbbbddabbcabbcccaddbaaac	TRUE
ccbadaacaccadb	TRUE
bcbdb	TRUE
caabbbd	TRUE
ccabaab	TRUE
daaccdbcadd	TRUE
dbbcaabcbdb	TRUE
bddbabaab	TRUE
cdbbbdcabddcbdbb	TRUE
dbdacbaaabaaacacacbcdcb	TRUE
bcaaaccacccdabbaabdadad	TRUE
aadabdca	TRUE
adbbbdbabaddcbabaabcdab	TRUE
dddabcdcddcccbbbddb	TRUE
cabcdbcaccdccacaaa	FALSE
dadbadcabdacbaaaa	FALSE
dbbadbbdcbcddcadcbbbbcaba	FALSE
cbdcccadbdaacaaaaac	FALSE
bdcdcddbdddaaaa	FALSE
aadabddddbbbb	FALSE
aabbbbaaba	FALSE
abcbccbbaaaaa	FALSE
dccbdaaccdabdcccabaaa	FALSE
adacdcbbbbad	FALSE
babbdbabcbcacaaa	FALSE
dddacdbdbadcbbbb	FALSE
ddacdbdbadcbbccbaaa	FALSE
cccadddbcdbabbccaaa	FALSE
caaaa	FALSE
ccadabcbcdcaaa	FALSE
abacdcdcbbabdacbbadaaa	FALSE
dadcccadddbcdbabbcdcaaa	FALSE
abdbaaaa	FALSE
badbcbcbacccaaaab	FALSE
aaacdaaaaa	FALSE
daabbbba	FALSE
bdcbcbcdcdaaaa	FALSE
bcaabbcddbabbdacaaa	FALSE
dadbbabccdaadaaaac	FALSE
ddaccbaaaa	FALSE
addadaaa	FALSE
cabdcdaaa	FALSE
bccdbcaaa	FALSE
bdccdacdccbddccbdaacaaa	FALSE
bcabadcabadadcbacaaa	FALSE
aabddbbcabccdaccaaa	FALSE
acbbaddcdcdbbdcdcdaccaaaa	FALSE
bbdaaa	FALSE
abcccabccdbcdaaa	FALSE
abccdbadcaaa	FALSE
ccdbcbabdaabbdcdcddbaaa	FALSE
ddaccbaaa	FALSE
ccdaaddaaddaaaa	FALSE
ddaacdaaaaa	FALSE
addddaaa	FALSE
adbcbbbdaddcbccbdcacadaaa	FALSE
cdccbcdccdbabcbaaaad	FALSE
abcbaabcbacbdcbcdbbbb	FALSE
cacdbadddaaa	FALSE
dddaccbaaaa	FALSE
cbbccbbcaabaadbaaa	FALSE
badddbddaaa	FALSE
acdbddaaa	FALSE
cdcddabcdcaabccdcaaaa	FALSE
abbbba	FALSE
abbddacbddbddcddccaadbaaa	FALSE
ddacbddbddcddccaacdaaaa	FALSE
adcabdacbabacbabcccabaaa	FALSE
bdaccbaaaad	FALSE
bddcabdbabdcdaaaa	FALSE
bbaabbcacaaa	FALSE
accbdabcbdcccadbdaacaaaab	FALSE
cdcaabccdcabcdbcaccdcdaaa	FALSE
dadcccadddbcdbabbccaacaaa	FALSE
ddacdbdbadcbdbaaa	FALSE
cbaaabcccdbcaaa	FALSE
caccdccacdcdbadbccaaa	FALSE
dcbcbcdccbcdaaa	FALSE
acadacbcaaaaa	FALSE
dddcacbabbddacbddbdaaaab	FALSE
bcadadacaaa	FALSE
cabcdbcaccdccaaaa	FALSE
abccaaa	FALSE
bcdadaaaa	FALSE
cbcbcdccbcdccaaa	FALSE
cbacabbdcbccacdbaccbbbb	FALSE
baaacdaadaaa	FALSE
cdadccbbaaa	FALSE
ccbcbbdddcaaadacbdacaaa	FALSE
bcbbbaccbcbacdabbdabdbbbb	FALSE
ddaaa	FALSE
ddaaa	FALSE
cdcaabccdcabcdbcacaaaa	FALSE
ccdacdccbddcaaaa	FALSE
aaa	FALSE
aaa	FALSE
aaa	FALSE
aaa	FALSE
aaa	FALSE
aaa	FALSE
aaa	FALSE
aaa	FALSE
aaa	FALSE
aaa	FALSE
aaa	FALSE
aaa	FALSE
aaa	FALSE
aaa	FALSE
aaa	FALSE
aaa	FALSE
aaa	FALSE
aaa	FALSE
aaa	FALSE
aaa	FALSE
aaa	FALSE
aaa	FALSE
aaa	FALSE
aaa	FALSE
aaa	FALSE
aaa	FALSE
aaa	FALSE
aaa	FALSE
aaa	FALSE
aaa	FALSE
aaa	FALSE
aaa	FALSE
aaa	FALSE
aaa	FALSE
aaa	FALSE
aaa	FALSE
aaa	FALSE
aaa	FALSE
aaa	FALSE
aaa	FALSE
aaa	FALSE
aaa	FALSE
aaa	FALSE
aaa	FALSE
aaa	FALSE
aaa	FALSE
aaa	FALSE
aaa	FALSE
aaa	FALSE
aaa	FALSE
aaa	FALSE
aaa	FALSE
aaa	FALSE
aaa	FALSE
aaa	FALSE
aaa	FALSE
aaa	FALSE
aaa	FALSE
aaa	FALSE
aaa	FALSE
aaa	FALSE
aaa	FALSE
aaa	FALSE
aaa	FALSE
ccddaaa	FALSE
aaaac	FALSE
dcabdbabdcddbccaaa	FALSE
aacdaaaa	FALSE
abaccaaaad	FALSE
cbaaabcccdbcabadcabadaaa	FALSE
bcbacdacdcdcadcaaa	FALSE
ddcaaa	FALSE
ddcaaadacbbaddcdcdbbdaaa	FALSE
adccbbaaaadb	FALSE
abaaa	FALSE
caadaabaaaa	FALSE
caabbcddcaaaad	FALSE
badcbbccbbcaabaadbaaa	FALSE
baaaa	FALSE
baaaa	FALSE
abcdcaabccdcaaa	FALSE
aaaab	FALSE
bcddbabbdbabcaaaa	FALSE
acabbdcbccacdbaccbbcbbbb	FALSE
aaaacdaabdaa	FALSE
dbcdbbaadbdcabccbaaa	FALSE
bdcbcadacbacaaadbaaa	FALSE
cdccdbabcbaabcddaaa	FALSE
daabbbbcd	FALSE
cddbbcaadaaa	FALSE
adcbbccbbcaabaadbcaabbbb	FALSE
ccdbcbabdaabbdcdcaaa	FALSE
aaccdabdcccabcaaaa	FALSE
cbabdaabbdcdcddbdddacaaa	FALSE
baabaaaa	FALSE
cddbbabacbaaa	FALSE
dcbcdbdadbbabdaaa	FALSE
bbba	FALSE
acadcddadbcbacaaa	FALSE
adcddbdbbdaaa	FALSE
dcccadbdaacadaaaaa	FALSE
ddcadcdbdbdabccbdabdaaaac	FALSE
bcaccdccacdcaaa	FALSE
abdbddcabdbabdcddbbbb	FALSE
cbaddddaaaac	FALSE
dbbadcaaa	FALSE
bdcbccacdbaaaa	FALSE
ddaaaa	FALSE
ddaaaa	FALSE
baaaac	FALSE
dcdacbbbb	FALSE
dbcdbabbccadabcbcdcaaa	FALSE
adbcbcbacccaabaaaa	FALSE
cdaaddacdaaaa	FALSE
cdbdbabcbaaa	FALSE
dcbccacdbaccbbcbbbb	FALSE
adbadcabdacbabacbabcaaa	FALSE
daacadaadcaddbbddaaa	FALSE
cdcadccbdbcdbbaadbdcaaaa	FALSE
dcbdddaaaccbacdddaaa	FALSE
bbdccaddaaaa	FALSE
caadaaa	FALSE
dcbcdbdadbbabccdaaddaaa	FALSE
cccdbcabadcabadaaa	FALSE
ddadcccadddbcdaaa	FALSE
dcccabcaddcaaaaa	FALSE
daabaccddaadbdcbcadaccaaa	FALSE
abccdacaaaac	FALSE
baccaaaac	FALSE
aaaacbc	FALSE
aaccdabdcccaaaa	FALSE
ddaaaccbaadaaa	FALSE
dcbaaabcccdbabaaa	FALSE
bddbddcbadacdbbbdaaccbaaa	FALSE
abdaabbdcdcddbdddaaaa	FALSE
daabaccddaadbdcbcaaaa	FALSE
bddcabdbabdaaa	FALSE
bbaabaaaa	FALSE
dcbaaabcccdbcabadcabaaa	FALSE
dcbcdbdadbbabccadaaa	FALSE
acabbdcbccacdbaaaa	FALSE
bbcabaaaad	FALSE
acbbacadcddadbcbacaaa	FALSE
cdcbbabdacbbdaabaaa	FALSE
bddcabdbabdcdaaa	FALSE
dbbdccdacdccbddaaa	FALSE
caadaaaa	FALSE
bcbcbacccaabaaa	FALSE
dccdacdccbddaaa	FALSE
caaa	FALSE
caaa	FALSE
caaa	FALSE
cbacbbacadcddadbcbacdaaaa	FALSE
ddcacbabbddacbddbdaaaa	FALSE
bcbadcacadccaaabaaacddaaa	FALSE
adbcbcbacccaababdbdaaa	FALSE
dbabcaaaad	FALSE
cadccbdbcdbbaadbdcabddaaa	FALSE
abbcdccbcbbdddcaaadaaa	FALSE
dccbdaaccdabdcccaaaa	FALSE
bccaaaa	FALSE
bbbda	FALSE
daaaac	FALSE
bbbcdbcccadbdabcbdaacbada	FALSE
dcdbdbabcbaaa	FALSE
abcbcaaa	FALSE
cdacaaa	FALSE
abacbabcccabccaaaa	FALSE
aaaddbdabaaaa	FALSE
ccbcdccdbabcbaabcddaaa	FALSE
cbacabdbcccbbaddadcddbaaa	FALSE
aaabddaaaa	FALSE
dbbcabdccdaaa	FALSE
badaaa	FALSE
dbadadacdbaccccacdacaaaad	FALSE
ddacdbdbadcbbccbbaaa	FALSE
ddaaaccbacddcbaaaaa	FALSE
caddbbdccdacdccbdaaaad	FALSE
aaaaca	FALSE
cbacabbdcbccacdbadaaa	FALSE
dccdacdccbddccbdaaccaaaaa	FALSE
dcccabcaddcbdddaaaccbaaa	FALSE
ccdaaa	FALSE
aaabdaaa	FALSE
cbddadcccadddbcaaa	FALSE
bacadcddadbcbaabbbb	FALSE
cdabacdcdcbbabdacbbadaaa	FALSE
daaabddaaaaad	FALSE
abcdcaabccdcabcdbcaaaac	FALSE
bbaaaaa	FALSE
abcccadbcadcadadcbaccdaaa	FALSE
acbabcccaccaaa	FALSE
cddbbdcbacbbacadcddaaaac	FALSE
acbabacbabcccaccaaa	FALSE
dcacaaaa	FALSE
badcddbdbaaa	FALSE
cbaabcbacbdcbaaa	FALSE
dadbcbacdacdcdcaddcaaa	FALSE
dcccabcaddcbdddaaaccaaa	FALSE
abcaaaac	FALSE
dbabcbbcaaa	FALSE
dbabdcddbbdcbacbbacaaaa	FALSE
cbcdcddabcdcaaaacdc	FALSE
dabdbcbbbaaa	FALSE
bdaacadaadcaddbbddaaa	FALSE
bdbadcbbccbbcaabaadbddaaa	FALSE
abaaaa	FALSE
dddaaaccbacddcbaaa	FALSE
bacaaa	FALSE
bacaaa	FALSE
dbdabcadaaa	FALSE
bcddbabbdbadaaa	FALSE
cbacbbacadcaaaab	FALSE
aacadaadcaddbbbbc	FALSE
bdabaaaa	FALSE
bdcbcadacbacaaadbadaaaad	FALSE
baccbbcbddaaaad	FALSE
adaaa	FALSE
adcbdabdcdabbbbbcdbcbcddd	FALSE
ddadcccadddbcaaa	FALSE
accbacadacaaa	FALSE
aaadacdbddaaa	FALSE
ccacdbaccbbcbddadccaaa	FALSE
cdcadccbdbcdbbaaa	FALSE
cdcadccbdbcdbbaadbbbb	FALSE
dcabccbcdabacdaaa	FALSE
cbcbacccaababdbddcabdaaa	FALSE
aaccdabdccdaaa	FALSE
bbddcbddbabbdadbccddbaaaa	FALSE
bacdcaadbdccbdaacadaadaaa	FALSE
bbdccadddcaaa	FALSE
cccdabcbcaaa	FALSE
ccdaaddaaddadbadcabbbb	FALSE
dcaaa	FALSE
dbabdcddbbdcbacbbacaaa	FALSE
abccdbaaaa	FALSE
adbbabccdaaddaaa	FALSE
bbccdbabaaa	FALSE
daaaada	FALSE
daaaa	FALSE
adcaaa	FALSE
bcabadcabadadcbacabbabbbb	FALSE
aabcbacbdcbcdbdadbbadaaa	FALSE
cbddadcccaaaab	FALSE
babacbcaaaa	FALSE
ccdaaddaaddadbadcabdaaaaa	FALSE
ddcabdbabdcdaaa	FALSE
ddbbcabccdaccbdadaaa	FALSE
bcdbabbccadabcbaaaad	FALSE
cbacabbdcbccaaaac	FALSE
daddaaa	FALSE
acadadaaa	FALSE
adbcbcbacccaaaab	FALSE
caabdacbaaa	FALSE
abacbabcccabccdbcdbaaa	FALSE
acccdcbaadadbaccccbbbcaaa	FALSE
cbcdccbcdccdbaaaad	FALSE
ddcabaaa	FALSE
cdcaabccdcaaaa	FALSE
baadbdcabccbcdabacdcaaa	FALSE
bcddbabbdbabcbaaaa	FALSE
dbabcbcaccaabaabddbbcaaaa	FALSE
cbbbccdaaa	FALSE
bcadadaaaa	FALSE
dbbabaaa	FALSE
baaaacdaaba	FALSE
dcbdddaaaccbaaa	FALSE
bdcbcadacbacaaadacbaaa	FALSE
ccabaaa	FALSE
bbdadddaaa	FALSE
dadddabdbaaaa	FALSE
ccdcabcdbcaccdccacdcdaaa	FALSE
cdadccbaaa	FALSE
aacacbbddcaccbbcdbbccbaaa	FALSE
abbccadabcbcaaa	FALSE
dcabdbabdcddbbdcbaaa	FALSE
accaaaac	FALSE
dabaaaa	FALSE
ddaaabddaaaa	FALSE
cacaaaa	FALSE
bcabccdaccaaaa	FALSE
acbdcbcdbadaaa	FALSE
dbbabacbcaaa	FALSE
cabdacbabacaaaa	FALSE
bcaabaadbcaabbbb	FALSE
ccadabcbcdcdaaaac	FALSE
dadbadcabdaaaa	FALSE
accbadabddcbdaabcddadaaaa	FALSE
dcbdbcbdddaaa	FALSE
babccdaaddaaddadbaaaa	FALSE
accdabbcaaaab	FALSE
dadaaa	FALSE
aabdaabaaa	FALSE
aaaacbcbadaab	FALSE
cbdddaaaccbacddcdaaaa	FALSE
dcccadccccadbadbaabccbbbb	FALSE
acadcddadbcbacdaaaac	FALSE
aabddbbcabccdaaa	FALSE
ccdaaddaaddadbadaaa	FALSE
ccaaa	FALSE
dbcbcdaaddddadbdccdabcaaa	FALSE
dcbdddaaaccbacddcbaaabaaa	FALSE
baaacaaaa	FALSE
dddacabbcaabaccbabddddaaa	FALSE
badbcbcbacccaabaaaa	FALSE
cccadddbcdbabbccadaaa	FALSE
bcddbabbdbabcbcacdaaaa	FALSE
cbbbadaaa	FALSE
cabccdaccbdabaaaa	FALSE
bcaaaabaa	FALSE
dacbabacbabcccabccaaa	FALSE
bcabadcabaaaabbc	FALSE
dcabdbabdcddbbdcaaa	FALSE
bdabdabbcccaacdbcbaabdaaa	FALSE
dcdacbbaaa	FALSE
cbccacdbaccbbcbdaaaa	FALSE
cbcccabaaa	FALSE
accbdabcbdcccadbdaacaaaa	FALSE
bcaaaab	FALSE
bcabccdaccbdabcbdcaaa	FALSE
abcbaabcbacdaaa	FALSE
cccadddbcdbabbccadabaaaa	FALSE
bccadabcbcdcaaaa	FALSE
dabcadaaa	FALSE
badcbbccbbdbaaa	FALSE
aabbbb	FALSE
ddbbcabccdaccbdaaa	FALSE
bccadabcbcdcdaaaac	FALSE
ccdbcbabdaabbdcdcddbddaaa	FALSE
daacdaaaaa	FALSE
accbacadaaaa	FALSE
ccbcdabacdcdcbbabdaaa	FALSE
ccbddccbdaaccdadaaa	FALSE
cdccdbabcbaabcbacbdcbdaaa	FALSE
aaabbaaa	FALSE
babbdbabcbcaccaabaabaaaa	FALSE
baaaacdaa	FALSE
daccadaaaaba	FALSE
daccadaaaa	FALSE
aabddbbcaccaaaa	FALSE
ddaaabadaaa	FALSE
abdacbbdaabaccddaadaaaa	FALSE
bdadddabbbb	FALSE
dbbdcadbaaa	FALSE
accaaa	FALSE
aaaacdaa	FALSE
abcccabccdbcdbaaa	FALSE
caddbbdccdacdccbddccbaaa	FALSE
badbcbcbacccaababdbdaaa	FALSE
aaaddbadacbddabbbaaabaaaa	FALSE
ccdcabcdbcacaaaa	FALSE
bcbbbaaacaaaa	FALSE
caccdccacdcdbadaaaab	FALSE
caccdccacdcaaa	FALSE
dcddcbabaaa	FALSE
daaa	FALSE
cabadadcbadcaaa	FALSE
dbacaaa	FALSE
dbabcbcaccaabaabddacaaa	FALSE
dabaaa	FALSE
bcbcbacccaaaab	FALSE
bbaadbdcabccbcdaaaa	FALSE
bbbaabbcabadb	FALSE
aaaa	FALSE
aaaa	FALSE
aaaa	FALSE
aaaa	FALSE
aaaa	FALSE
aaaa	FALSE
aaaa	FALSE
aaaa	FALSE
aaaa	FALSE
aaaa	FALSE
aaaa	FALSE
aaaa	FALSE
ccdacdccbddaaa	FALSE
dddacabbcaabaccbabdaaaa	FALSE
ccbbaaaa	FALSE
adbcbacdacdcdcadccbdaaa	FALSE
bcabadcabadadcbacabbbb	FALSE
aaaaa	FALSE
aaaaa	FALSE
aaaaa	FALSE
aaaaa	FALSE
aaaaa	FALSE
aaaaa	FALSE
cbdddaaaccbacddcbaaaaa	FALSE
aadbcaabbcddbabdaaaa	FALSE
bcdaaaa	FALSE
bdcdcddbdddacdbbbb	FALSE
dabcbdcccadcdaaa	FALSE
ddaacdaaa	FALSE
adbadcabdacbaaaa	FALSE
ddacdbdbadaaaa	FALSE
adcabadadcbaaa	FALSE
bcabadcabadadcbaaaa	FALSE
cbbbdaaa	FALSE
bcddbabbdbabcbcacaaaa	FALSE
ddacdbdbadcbbccbbdbaaa	FALSE
adaaaa	FALSE
cacbabcbdaddacbdbcccddaaa	FALSE
dcdbdbaaa	FALSE
addaaaa	FALSE
addaaaa	FALSE
addaaaa	FALSE
cccabcaddcbddaaaa	FALSE
adddbddaaa	FALSE
bbdccadaaaa	FALSE
bbaaacaaaac	FALSE
daadbdcbcadacbacaaa	FALSE
cbcbacccaababdbddcabdaaaa	FALSE
aacadaadcadaaa	FALSE
dabccaaaaa	FALSE
acdcdcbbabdacbbadaaa	FALSE
badcbbccbbcaabaadbddaaa	FALSE
baaaadb	FALSE
adcabdacbabacbabcaaa	FALSE
acdccbddccbdaaaaa	FALSE
accbdabcbdcccadbdaaaaa	FALSE
aaabadaaa	FALSE
