ddacddadadadcdaacc	TRUE
bacacadcaacdad	TRUE
addaddcaddcacacaacccaca	TRUE
cccccdbdccbccdddb	TRUE
aaccaccdcaac	TRUE
aa	TRUE
daadddadccacdacdadaa	TRUE
acaadacaadcdaccccddc	TRUE
cadacd	TRUE
cdddbcaddacaaccaacadadaaa	TRUE
dcaacc	TRUE
bccbcbdaadccaacddaa	TRUE
cdacccaaaddccaaadccdac	TRUE
ccdddbd	TRUE
ccaccaa	TRUE
ddbbdcbdcbacaddcadada	TRUE
cbdcbddcddcccdbadccadaaac	TRUE
aaaacadccada	TRUE
acaadd	TRUE
acaccacaccacdddacdaadacdd	TRUE
ccdddcdbbdaddcdacdacdaa	TRUE
dbbadacaccaaddcddccc	TRUE
dcccb	TRUE
bacdaccaaccccaddcacca	TRUE
ddccbbbadccdc	TRUE
acacada	TRUE
ddbbdcbdcbacaddcadadad	TRUE
bccdaa	TRUE
dcccdddcdbbdaddcdacdac	TRUE
acaacda	TRUE
dcdbbbbb	TRUE
ccaadd	TRUE
dbbbbdcacdaccccddccdaaad	TRUE
a	TRUE
a	TRUE
a	TRUE
a	TRUE
baacacad	TRUE
cbcbdaada	TRUE
ddddcbccdcaccaaccddd	TRUE
ccdcdaadcdddddcdaca	TRUE
dbbdaaaadddddcad	TRUE
cdbdccbccdddbc	TRUE
ccccbacdaadacacaccc	TRUE
dddcaccdd	TRUE
cccdcdbcd	TRUE
baaccdccdcaacdcaa	TRUE
bcbdaadccaacddadadadcdaa	TRUE
dcbaccadaddcacaccc	TRUE
dcccdddcdbbdadddc	TRUE
dcccdddcdbbdaddcdad	TRUE
bdccccacaacdcaacddaaccaa	TRUE
cadacdaada	TRUE
ddbdbadadaa	TRUE
daad	TRUE
baaadccdaccad	TRUE
adacdaadaaaaccdd	TRUE
adacaaccaacaad	TRUE
addacaaccaacaaada	TRUE
dbadcdcdaaaada	TRUE
dcddddbc	TRUE
bbacaccccaccacacaadcada	TRUE
daddadccacdacdadaacaa	TRUE
cacaccacacad	TRUE
ac	TRUE
baacaccacdddacdaadacdd	TRUE
bcbcacddadacaddccca	TRUE
aadaaccacca	TRUE
bacaddcadada	TRUE
ccbddccccccdbdccbcb	TRUE
dbbadacaccaaddcddccccddcc	TRUE
dcbbdbca	TRUE
bdadac	TRUE
dcdb	TRUE
accacacad	TRUE
ddbbddcbaaadccdacd	TRUE
aadaccaccdc	TRUE
dcddbbddcbaaadcca	TRUE
dcddddbcccbaacc	TRUE
acddadacaddcccaaccddad	TRUE
caaaddcdcddcdcccaadccdaaa	TRUE
cbaaccdccdcaacdcaacd	TRUE
dcacadaadddadacddcaadacaa	TRUE
bacacadcadaacaacda	TRUE
baac	TRUE
bdaadadadcdaaccaacdcdccdd	TRUE
ccbb	TRUE
dddaacacdc	TRUE
dadaacadacccdadcccaa	TRUE
cccaccacdacdaa	TRUE
cdbdccbccdddbcaddacaa	TRUE
acaacddd	TRUE
bddbbcacdccdadacccad	TRUE
ddddadccddcadcccdc	TRUE
bcbcacddadacaddcc	TRUE
adadacd	TRUE
caadd	TRUE
bacaddcadadadaccddcddca	TRUE
baddcddcdcdaaaadddddad	TRUE
dcbbdbcaca	TRUE
b	TRUE
b	TRUE
b	TRUE
b	TRUE
b	TRUE
b	TRUE
b	TRUE
b	TRUE
b	TRUE
b	TRUE
b	TRUE
b	TRUE
b	TRUE
b	TRUE
b	TRUE
b	TRUE
b	TRUE
b	TRUE
b	TRUE
b	TRUE
b	TRUE
b	TRUE
b	TRUE
b	TRUE
b	TRUE
adadacdaadaaaaccdcaaaaada	TRUE
dbbbbdcacdaccccddccdaac	TRUE
cccdaaa	TRUE
dbac	TRUE
ccdbccbbcacaadcdcacdadacd	TRUE
ddddadccddcadcccdcaccac	TRUE
bacacdddacdaaacd	TRUE
bcacaacddadadadca	TRUE
cbbbadccdcddadacda	TRUE
addaddcaddcacacaacccadcc	TRUE
ccbddbbcacdccdad	TRUE
cbaaccdccdca	TRUE
cdaad	TRUE
dbddbdcdcdddbca	TRUE
bbbbb	TRUE
cccdbdccbccdb	TRUE
bbaaaccccaddcaccacaccaad	TRUE
bbcbccdaadddadcc	TRUE
dbcdcccddd	TRUE
dcaaccdccadaddcaccacddcc	TRUE
cacaacdcaacddaaccdadcddaa	TRUE
ccaccacdacdadaacaaadaccad	TRUE
dadaacadacccdadcccaaadcad	TRUE
daaacaaadaccaccdcca	TRUE
aaa	TRUE
aaa	TRUE
bbdada	TRUE
baccacaddccdcaaddcaccad	TRUE
ccbaaccdc	TRUE
addacaaccaacadadaaa	TRUE
aaddcaccacdda	TRUE
bdcbacdac	TRUE
dddcdbbdaddcdacdacdacaccd	TRUE
ccaccacdacdaa	TRUE
bbdcdbcdbbbbcaacddaaaaadd	TRUE
dbdbbbc	TRUE
cccaccacda	TRUE
ccc	TRUE
cacaccacacc	TRUE
adadacdaaaca	TRUE
bcdccaadaacccaaaddccaaad	TRUE
cbaaccdccd	TRUE
dbcdcbbdbcbb	TRUE
baaccaaccd	TRUE
caaa	TRUE
ddcacdac	TRUE
bcbacaddcddaddcada	TRUE
bcacaacdad	TRUE
bdaddcadcccdcaccaca	TRUE
cb	TRUE
cb	TRUE
cb	TRUE
adadaca	TRUE
cbcbdaadccaacd	TRUE
cddd	TRUE
dcbbaddcdcaaadaaacacdccad	TRUE
daadddad	TRUE
acdccdadacccaddcddadd	TRUE
dbadcdd	TRUE
dcaaccdccadaddcac	TRUE
bdadadcccaaaac	TRUE
dbcdcbbdbca	TRUE
bccbcbdaada	TRUE
dbcdcccdddcdbbdaddcaa	TRUE
cccacc	TRUE
dbdb	TRUE
baddcddcdcdaaaadddd	TRUE
cbbdcccbddcccc	TRUE
ddccbbbadccd	TRUE
cccccdbdccbccdddbcad	TRUE
dbdccbccdddbcad	TRUE
cdddcdbbdadaa	TRUE
dcccdddcdbbdaddcdacdacda	TRUE
acaacdcaa	TRUE
ccb	TRUE
cbaaccdccdacdd	TRUE
cacacddddaacccccaaaacccdc	TRUE
cacaccacaccacdddac	TRUE
dddcaccddaadcaddd	TRUE
accdd	TRUE
bccdcaccaaccdddccdaadaa	TRUE
cadaadddadacddcaadacaa	TRUE
adadacdaadaaaaccdcaaaa	TRUE
ddacddadadaac	TRUE
ddddadca	TRUE
bacdaccaaca	TRUE
bbdadadaacaaadaccaccdc	TRUE
bbbadccdcddadacdaadaaaac	TRUE
caaddcaccacddccdacdddc	TRUE
dcbcdbbbaaccdccdaccddcddd	TRUE
ccaaddcac	TRUE
dcba	TRUE
ccacccaaadcacddccdccdaaa	TRUE
dadaacadacccdadccadcdd	TRUE
dadaacadacccdadd	TRUE
ccaa	TRUE
cbaddcddcdcdaaaaa	TRUE
caaddcaccac	TRUE
acaccacaccacdddac	TRUE
dbbdaddcaa	TRUE
bdaccaccacacaadccaaaccaa	TRUE
bacacadaadc	TRUE
dc	TRUE
daa	TRUE
dddcacc	TRUE
bbdadadaacaaadac	TRUE
aadac	TRUE
cadacdaaadcaa	TRUE
dddcaccdaad	TRUE
ddcddcaccddccddacdcdd	TRUE
dbbcaddadac	TRUE
baaccaaccccaddda	TRUE
ddddbc	TRUE
ccacdcaacddaaccadd	TRUE
ddddbcc	TRUE
dcc	TRUE
cbbbadccdcddaaa	TRUE
dbddbdcdcddb	TRUE
aadaaccdaada	TRUE
cbaacc	TRUE
dcbaccadaddcacdd	TRUE
cdcdbb	TRUE
caadaccaccdccadaddad	TRUE
ddccbbbaa	TRUE
cdcd	TRUE
baaccdccdca	TRUE
cdcdaadcddddd	TRUE
ddddacaacadaddd	TRUE
bcacaacddadadadcdaaccaa	TRUE
dccadaaaaccdcaaaaaaaada	TRUE
bacdacdaa	TRUE
dcaccaaccdddccdaadada	TRUE
cadd	TRUE
bacaddcddaddcaddcacadc	TRUE
ccaccacdacdadaa	TRUE
dccbaddcddcdd	TRUE
baaccdccdcaacdcaacddaa	TRUE
cca	TRUE
bdcbacdaccaacccca	TRUE
ddcdac	TRUE
cddaddddcacddacadaacaac	TRUE
accacaddccadcdccacacddcac	TRUE
adaaaaccdcaaaaada	TRUE
bbcbccdaadddadccaca	TRUE
bcbacdddddaccdddaaddaaacc	TRUE
cbaaccdccdcaacdcaac	TRUE
daddccddaccadaadddadacdd	TRUE
ddd	TRUE
daccddaccadaadddadac	TRUE
baddcddcdcdaaaadddad	TRUE
bddccccccdbd	TRUE
dcccdddb	TRUE
cccccdbdccbccdddbcaddaaa	TRUE
bcb	TRUE
cbccdddbcbda	TRUE
bbb	TRUE
bc	TRUE
bcbbbbbccdccbada	TRUE
aadcddddcadadadcaaaddcdad	TRUE
bbbcbdadadcccaa	TRUE
cdccbaddcddcdcaddd	TRUE
caadaccaccdcc	TRUE
bdaadadadca	TRUE
dcbbdbcaccacaaccddaad	TRUE
bb	TRUE
bb	TRUE
bb	TRUE
bb	TRUE
bb	TRUE
cdaaacaaaa	TRUE
aacadcadaacaacda	TRUE
dbbdaacadaacadaccc	TRUE
addcacacaacccacddadac	TRUE
cbaddcddcdcdaaaadddad	TRUE
bdcbaca	TRUE
cbaaccdccdcaacdcaacdd	TRUE
ccbbc	TRUE
bdaadccaacddadadadca	TRUE
dcdddd	TRUE
dcdbbbaacddccdacacc	TRUE
caacdadacccdcaddaacdcccca	TRUE
dcdaadcddd	TRUE
dddcdbbdadaa	TRUE
dbdbbbcca	TRUE
bbbadccdcddadacaccd	TRUE
aadaacccaaaddcca	TRUE
dcbac	TRUE
dcbac	TRUE
baddcddcdcdaaaadddddcacdd	TRUE
adaccccddccdaacaaddcaccca	TRUE
dcdbbbaacddcca	TRUE
dddaacdaada	TRUE
accac	TRUE
cacccaaadcacddcdd	TRUE
aaccaccdccadaddcaccac	TRUE
dcddddbcccbaaccd	TRUE
dcdaadcdddddcdacacdca	TRUE
ddddacaacadadddacaaa	TRUE
dddcaccddaadca	TRUE
ccaaddcaccacddccdaccaaccd	TRUE
baaccaaccccaddcacada	TRUE
dbbbb	TRUE
dbbdaacadaacad	TRUE
addadacda	TRUE
cbaddcddcdcd	TRUE
adcccacaddccdcaaddcaccadd	TRUE
aadaacdaa	TRUE
bbbc	TRUE
cbaaccdccdadd	TRUE
bcdccaadaacdaa	TRUE
ccd	TRUE
cbbdcccbddcccccb	TRUE
adad	TRUE
bacac	TRUE
bccbcbdaadccaacd	TRUE
cdddcb	TRUE
cdaaa	TRUE
bdccaada	TRUE
aacadcadaacaacdaadaa	TRUE
cda	TRUE
dbdbbbccacacca	TRUE
bccdaaddacaa	TRUE
baacaa	TRUE
cdcdaadcdddddcdaadaa	TRUE
accddaadcadddadccacdaac	TRUE
cacaccacaccacdddacd	TRUE
cbbbadd	TRUE
ddaddddcacddacadaacadacc	TRUE
cacada	TRUE
bbc	TRUE
cacccaaadcacddccda	TRUE
dbdbbbccacada	TRUE
dccaadaacccaaaddcca	TRUE
cdacccaaaddccaaadccaa	TRUE
dbcdcbbdbcaccaca	TRUE
cbcbaccddcaaadd	TRUE
aaccdddccdaadacaccaaddca	TRUE
cadaaaaccdd	TRUE
cdbbdaacadaacadad	TRUE
baacdddc	TRUE
cdcdaaad	TRUE
bacacadca	TRUE
bacacdddacdaadacdccdc	TRUE
acccaaadcacddccdccd	TRUE
dddcdbbbb	TRUE
cccdcdaadcddddaca	TRUE
cbaaccdc	TRUE
bacaddcddaddcada	TRUE
aacadc	TRUE
acaccacacc	TRUE
bdbaaddaddaadddaadcacdadd	TRUE
cbbdcccbddccccc	TRUE
bcdcbbaa	TRUE
bdcbacdacacc	TRUE
ccaccacdaac	TRUE
dcddddadca	TRUE
cddaddddcacd	TRUE
ddddadcaa	TRUE
acaacddadadadcdaaccaa	TRUE
dbb	TRUE
dcaaaacadc	TRUE
d	TRUE
d	TRUE
ccca	TRUE
cdaccdaada	TRUE
aaccaaddcddccccddccdda	TRUE
badaa	TRUE
dcbaccaadd	TRUE
dbbdaacadaacadacccd	TRUE
aadaccaccdccadaddcaccac	TRUE
bacaddcadadadaccddcddcdd	TRUE
caadaccad	TRUE
cdddcaccddaadcadddadcc	TRUE
baaadccdaccadca	TRUE
cdaaaca	TRUE
cbdddcbcbacaddcddaddcadda	TRUE
cc	TRUE
dbbb	TRUE
cbbac	TRUE
cccccdbdccb	TRUE
daadddadccacdacdadaacaaa	TRUE
cbbbadccdcddadacd	TRUE
bdcbacaddcada	TRUE
ccaadda	TRUE
cacdcaacdd	TRUE
ccddcddcaccddccddacdcdd	TRUE
bcbacaddcddaddcadda	TRUE
cacac	TRUE
baccdcaaaa	TRUE
dbcdcbbdbcaccacaaccddaadd	TRUE
ddddacaacadadddaaa	TRUE
bcdccbbb	TRUE
cadacdaadaaaac	TRUE
bcacaacddaad	TRUE
dadaacadacccdadccaacd	TRUE
cdddbcaddaa	TRUE
bccdddbcaddaaaad	TRUE
addacaaccaaca	TRUE
ba	TRUE
ba	TRUE
ba	TRUE
cccacaacdcaacddaaccdaad	TRUE
bdccaa	TRUE
ccacc	TRUE
cdddbd	TRUE
baa	TRUE
bdc	TRUE
cdddcaccddaadcaddd	TRUE
acaadccdcdcaacddcdcdacddd	TRUE
cdb	TRUE
ddbbdcbdada	TRUE
cbcbaccdd	TRUE
cbcbaccdcaaaaadaac	TRUE
caaccad	TRUE
cba	TRUE
dbcdb	TRUE
bdcb	TRUE
ccdbdccbccdddbcaddacaa	TRUE
cdbdccbccdddbcaddacaaaa	TRUE
bbaa	TRUE
acaccacaccacdda	TRUE
daadcdddddcdacacdccdac	TRUE
cacaacdcaacdadaa	TRUE
bacacdddacacdc	TRUE
dccbcbcacddadacadd	TRUE
ad	TRUE
cccdbdccbccdddbcad	TRUE
bcbcacddadacaddcccaaccddd	TRUE
bbbcdbbbcbcbbacdcaaccccad	TRUE
addaddcaddcacacaaccc	TRUE
caadaccaccdcca	TRUE
acca	TRUE
caadaccaccdcaac	TRUE
dbcdaca	TRUE
db	TRUE
db	TRUE
aad	TRUE
adddddcccacaddccdcaaddaa	TRUE
accacdacdadaacaaa	TRUE
aaccdcca	TRUE
baaccdc	TRUE
aadaacccaaadd	TRUE
cadacdaadaaaaccdcaaaa	TRUE
dcddddadccddcadcccdcacaa	TRUE
dcddbbddcbaaadccdaccadcca	TRUE
bacdddacdaadacdccdcddad	TRUE
cdaadddad	TRUE
accddaadca	TRUE
dcddddbcccbaaccdcc	TRUE
ddddadccddaca	TRUE
cacccaaadcacddccdccdaaa	TRUE
dddcaccddaadd	TRUE
dddcaccddaadcad	TRUE
bacaddcddaddcadda	TRUE
acdcdaaaadddada	TRUE
bbdbc	TRUE
adaccccddccdaacaaddcac	TRUE
baacadccacadc	TRUE
bdcbacdaccaaccd	TRUE
cadaaaac	TRUE
ddbdbaddaacc	TRUE
bddbbcacdccdaaa	TRUE
dbadccacadcaaaa	TRUE
bccdaad	TRUE
bcbbbbbccdccbaa	TRUE
dccaadaacccaaaddcdcc	TRUE
bacdacda	TRUE
cbbbadccdcddadacaccd	TRUE
bacdaccaaccccaddcaccaca	TRUE
accacdacdadaacaaaa	TRUE
bcbbbbbccdccba	TRUE
dcdaadcddddaca	TRUE
bcacaacddadadadcdaacca	TRUE
ccacaacdcaacdac	TRUE
dddcacca	TRUE
aababbdddcbacabcadabcba	FALSE
dbbdadcdbc	FALSE
bcdbaaabadcbdccdacbdcdbac	FALSE
adabccbdaacbbbb	FALSE
abcadabccbdaacbbacd	FALSE
bdcbdabdbabadccbdbdbbac	FALSE
cbabdccc	FALSE
ddddbccdcab	FALSE
ccabaacadcdcddcacb	FALSE
accdadbbdaddbadbddba	FALSE
abbdcbcdbaaabad	FALSE
dbbbcbcbdbccabcdcca	FALSE
bbcbccdadb	FALSE
dabdccacad	FALSE
aabdbddcdbbbcbcbdb	FALSE
dacb	FALSE
accdadcddbbdd	FALSE
dddabc	FALSE
baadcbadadbbacdcc	FALSE
bdcbabbdccadbcccbbbccb	FALSE
cacbdbdbccaacaabadaccaadc	FALSE
bbbbbdbbdcddddcbaadcb	FALSE
cdcccdcabddbbdcbaaacadcbb	FALSE
accaddba	FALSE
dacbdcdabbddacaabbb	FALSE
aabadcbdccdacbdcdabbdda	FALSE
ccbabdccc	FALSE
cbdcbbbaabaabdbcacbcdabac	FALSE
cbdbdbbacadcdabdabd	FALSE
accaddbdb	FALSE
dcbab	FALSE
aabdbddcdbbbcbcbdbccabcdc	FALSE
cadcadcbaacc	FALSE
adb	FALSE
abbdcbcdbaaabadcbdccd	FALSE
dcbadadbbacdcccbbcdbbabcb	FALSE
ccbbaaaaaaaddadcccacb	FALSE
dbab	FALSE
dbab	FALSE
cccdbdccbcacb	FALSE
ccdbdcbdddabddb	FALSE
ccaababbdab	FALSE
cbccbaadb	FALSE
bbcccbbccbdaaccbd	FALSE
babab	FALSE
dbabab	FALSE
abcdccaabbcddbbcd	FALSE
cbccbcbdabc	FALSE
accadbb	FALSE
dbbdaddbadbddbbd	FALSE
abbdcbcdbaaabadcbdc	FALSE
dccaabbcddbbcdcdabbb	FALSE
dcdadbddbbb	FALSE
abcd	FALSE
aabccadbccbacdcadcdccdcdb	FALSE
cbddccccabb	FALSE
bbdcbcdbaaabadcbdc	FALSE
cdbab	FALSE
aba	FALSE
cbabdccccacbb	FALSE
baacadcdcddcacabdcdab	FALSE
cbdbbacdcabcbbdabcaaddbbb	FALSE
dbddbacbdbbcbdcbab	FALSE
caddccccdcdbbadb	FALSE
badcbcdcca	FALSE
dbabaab	FALSE
abbdcbcdbaabcd	FALSE
bcbcdcbcaccdadbbdaddbabb	FALSE
ddab	FALSE
dcbcaccdadbbdaddbadbddbbd	FALSE
ddccbbbadbbca	FALSE
dbddbacdaabacdbcdcdacdbab	FALSE
dbbabcbcdcbcaccd	FALSE
cbdbbcbdcbdabdbabadccbbb	FALSE
daabadbadcccbcabcdcddaadd	FALSE
bbdaddaadcaaaabcdcddbadbb	FALSE
bdaaccdcdbdacd	FALSE
ccdbacdacaddccdddccdadbcb	FALSE
caccdabcb	FALSE
cdab	FALSE
cdab	FALSE
addcbbadddaabbbbbdbbdcdb	FALSE
acaccabaacadcdcddcacabdb	FALSE
dccdbaddadcbcbb	FALSE
cbbbadbbcaac	FALSE
bdaacbaaadcdcaaacaddacb	FALSE
addcbbadddaabbbbbdbbdab	FALSE
caababbdddcbacab	FALSE
baaddcbaadabdccdacbaaa	FALSE
dbccaddccccdcdbbb	FALSE
ccdaccbbaaaaaaadd	FALSE
ddacdcccbdabbdcdacaabbbdd	FALSE
caaabadcbbdd	FALSE
acbbbccadaccdbaabdca	FALSE
dabdaaabdbdddbc	FALSE
aababbdacdbc	FALSE
dcdbbbabddbb	FALSE
aabbcddbbcdcdabcdbdad	FALSE
cdacbccacbacdbaacbdaacba	FALSE
ddddbab	FALSE
bacbccbcbdabc	FALSE
ddcbbadddaabbbbbdbbdab	FALSE
aaddcbbdcdbadaabaacaabcba	FALSE
bdaaabbcccbbcda	FALSE
acadadccb	FALSE
caabbcddbbcdcd	FALSE
cadcdabdaaabdbddcdbbbdbc	FALSE
caddbdbacc	FALSE
cbccbdcaadbcdbdcddbdcbcda	FALSE
ccbabd	FALSE
dbdbab	FALSE
dcddddabdabca	FALSE
bcbdaaccddbacbdcdbccbddcc	FALSE
cadaccdbaabdcaabdbbacdacb	FALSE
bbccbdaaccdcdbdaccdacd	FALSE
bacabcadabccbdaacbbbb	FALSE
bbdcbcdbaaabadcbdccdaa	FALSE
aaaaaaddadcccaccccdbba	FALSE
dbcdbddbdbadcadb	FALSE
addbdbaccabb	FALSE
dddcabbb	FALSE
caaabadcbabab	FALSE
bbbadbb	FALSE
adbccaddccccba	FALSE
cdadb	FALSE
adabccbdaacbbacd	FALSE
babbddccabcdcabbcadaabdda	FALSE
bcaddabd	FALSE
bbadddaabbbbbdbbdab	FALSE
bdbbacdacbccacbacdba	FALSE
cdacbccacbacdbaacbdaa	FALSE
dbcdcccdab	FALSE
aabadcbdccdacbdcdabbddac	FALSE
ababbdddcbacabcadabccbda	FALSE
bcaccdcbaadaabcddcdacbdba	FALSE
bbcccbbccbdaaccdcdbd	FALSE
bdccdacbdcdabba	FALSE
accabaacadcdcddcaaad	FALSE
aaaccacdaabdddacbbdbbaacb	FALSE
addcbbadddabddddcb	FALSE
aabacccbbdddcbadabaadddac	FALSE
accbbd	FALSE
bbcddbbcdcdabcdbdad	FALSE
bddababcabdcbacbdbbbbbdab	FALSE
bbccbdaaccdcdbdaccdaccbba	FALSE
cacbacdbaacbdaacbaaadcdca	FALSE
bdabdbabadccbdbb	FALSE
badbb	FALSE
bdcbabcbbbbb	FALSE
bbab	FALSE
bbab	FALSE
cdddcdbbdab	FALSE
bbbaab	FALSE
bbcbccdadacb	FALSE
caaabadadb	FALSE
cbbdcbab	FALSE
baadcbadadbbaa	FALSE
caaaabbaccabacbbacadbdabd	FALSE
baaddcbaadabdccdacbaa	FALSE
acddddaddbbd	FALSE
cbdcdabbddacaababbddd	FALSE
ccdaccbbaaaaaaaddad	FALSE
bdabdbabadccbdbdbbacadcdb	FALSE
dcdadbddbd	FALSE
bab	FALSE
bab	FALSE
bab	FALSE
bab	FALSE
bab	FALSE
bab	FALSE
cdabbddddbdbdbbbdcdddabb	FALSE
dcccaccccdbdcbddd	FALSE
dcddddabdb	FALSE
abbcddbbcdcdabcdbcdbad	FALSE
adbccaddccccdcdbbaa	FALSE
cdcbcbadccdbaddad	FALSE
bbdddcbacabcad	FALSE
cadadb	FALSE
dbccaddccccdcdbbadbaabb	FALSE
cbbccbdaaccdcdbdaccdacaa	FALSE
ccbab	FALSE
badccbdbdbbaba	FALSE
ccdcdccacddbcdbbdccbdabdc	FALSE
dadbbdaddbadbddba	FALSE
cbdbbcbdcbdabdbabad	FALSE
ababbdddcbacabcadabccbdaa	FALSE
bcdcabab	FALSE
cccacb	FALSE
bccbcbdabc	FALSE
dccbdbdbbacadcdabd	FALSE
cdddcdbbdadba	FALSE
ccdaccbbaaaaaaaddadc	FALSE
dbbabcbcdcbcaccdbb	FALSE
bacaaacdabbdbabdbbcadacaa	FALSE
abcccbdddaccdaacbcacacbba	FALSE
cbaccbacdaccddccccbdcadbd	FALSE
addaaaddbbcacbcdadbbdbcda	FALSE
dbcab	FALSE
bcdcab	FALSE
cccdddacb	FALSE
cadadccacb	FALSE
bdcbabb	FALSE
caabacdddabadbbdabaadcabc	FALSE
cbbaaaaaaaddab	FALSE
cadaaabcdbbccdbccadddaabd	FALSE
adbccaddccccdcdbbadba	FALSE
badbabaadbd	FALSE
bdbbcbdcbdabdbabaaba	FALSE
ccaccccdbdcbda	FALSE
abdcddbdcadaabaaddb	FALSE
dccdbaddadcbcbbcac	FALSE
acaccabaacadcdcddcacabd	FALSE
dcbabb	FALSE
bacbcbcdcabbabbbbacadcdab	FALSE
dbcdadbc	FALSE
dbddbdbadcadbcc	FALSE
bcdccaccdbdb	FALSE
ccccacacccdddabdcdcbaabcc	FALSE
cadcdabdaaabdbdd	FALSE
cdbaadbbdacdd	FALSE
bbbdbabdcabaadbbcbbadaada	FALSE
acaddacddadbabdabadcba	FALSE
bbbab	FALSE
bdccdacbdcdabbdd	FALSE
bccbdaacbbacad	FALSE
adccbacaadbadccabdcaacabc	FALSE
acaccabaacadcdcddca	FALSE
acaccabaacadcdb	FALSE
baaddcbaadabdccdacbaacbbb	FALSE
ddbdab	FALSE
bdaabadcaddabcadbdcbccddc	FALSE
dcbbdbcadb	FALSE
bbbbbdbbdcddddab	FALSE
bccbcbdabcab	FALSE
aabadadb	FALSE
cbbbadbbca	FALSE
abaaddcbaadabdccdacb	FALSE
bbdbcaadbdbcadaababaacbab	FALSE
ccacb	FALSE
badadbbacdcccbbcadcb	FALSE
dcdabdaaaaccacadacacdabba	FALSE
bddcccadb	FALSE
abb	FALSE
abb	FALSE
abb	FALSE
bbacdcbcbadccdbaddadcba	FALSE
babdc	FALSE
abadcbbdd	FALSE
aabad	FALSE
abcadabccbdaacbbbb	FALSE
cbbbadbbc	FALSE
bbacdcbcbadccdbaddadcbcbb	FALSE
cccdcdadbddbd	FALSE
dcdabdaaabdbddcdbbbdbc	FALSE
addcbbadddabbdcdb	FALSE
bcbadccdbaddadcbcbb	FALSE
aababbdddcbacab	FALSE
baddccbdacdbcbbbaccdbaaaa	FALSE
dbccaddccccdcdbbadbaaabbd	FALSE
cdadcddbbb	FALSE
bacabcadabccbdaacbba	FALSE
dbbcaacadab	FALSE
cdbdcbdddaaddcbbaddda	FALSE
accdadbbdaddbadbddbacbb	FALSE
bdddaaddcbbaddda	FALSE
daccbab	FALSE
dadacb	FALSE
dcdabdaaabdbddcdbbbcbac	FALSE
abbdcbcdbaaabadcbdcd	FALSE
dbbbabddbb	FALSE
babbdacdb	FALSE
adcdcddcacabdcddbdcada	FALSE
ddbdccaababbddacaaddbcdbd	FALSE
bbbccadaccdbaabdcaabb	FALSE
bdcdabbddacaab	FALSE
cdddbab	FALSE
dddcdbddbcbbadcacdacbddaa	FALSE
caadcabbddcccdbcccdbbdbbb	FALSE
bdbddcdbbbcbcbdab	FALSE
acbcddcbcddbdaadcccbcadab	FALSE
cbdbbcbdcbdabdb	FALSE
ccaddbdbacc	FALSE
bdbddcdbbbcbcbdbccabb	FALSE
baaadcdcaaacaddacdaba	FALSE
ddadcccaccccdbdcbb	FALSE
dddcabbcb	FALSE
adcbadadbbacdcccbb	FALSE
adcbadadbbacdccd	FALSE
bdab	FALSE
bdab	FALSE
dacbaacbbbccadaccdbaabd	FALSE
dadbbacdcccbbcdbbabcb	FALSE
bbcdbbabcbcdcbcac	FALSE
bdbddcdbbbacdb	FALSE
cacb	FALSE
acbcbada	FALSE
cabcdcddcbdacdadbbbacbbba	FALSE
dcddcacabdcddbdcb	FALSE
adcdcaaacaddacddadbabdab	FALSE
cdbaddadcbcbbc	FALSE
cdbaabdcaabdbbacdab	FALSE
caccccdbdcbdddaaddbb	FALSE
caabbcddbbcdcdab	FALSE
bccdddbab	FALSE
aadbcdabdbacbcabcbccbcada	FALSE
ccbabdccccac	FALSE
aabbcddbbcdcdabcdbcdbddbb	FALSE
cadadccacbddc	FALSE
bcbbbbbccdcab	FALSE
adcba	FALSE
cacadcadcba	FALSE
bdbdbbacadcdabdaa	FALSE
dacbaacbbbccadacca	FALSE
ddaabdcbabbdccadbcccbbbcc	FALSE
dddcabbcbca	FALSE
bdcdabbddacaababbddd	FALSE
cddbbbdaabbdacaaddabcadcb	FALSE
aabbdcbcdbaaabadd	FALSE
cacaddb	FALSE
dab	FALSE
dab	FALSE
dab	FALSE
bcdbdaccbccaabcdbdadadacb	FALSE
babbadbdbbb	FALSE
dbbdabbdbadbdacbcdcbabccc	FALSE
abd	FALSE
abd	FALSE
aaaaaaddadcccab	FALSE
dcbcbadccdbaddadcbda	FALSE
acaaacdcbdcbbacdbaacabacb	FALSE
cacadcadcbaac	FALSE
dcabbbcc	FALSE
cbdaacbaaadcdcaaacaa	FALSE
ccaccccdbdcbdddaadd	FALSE
cabddc	FALSE
dbcdcbbdbbab	FALSE
adcbaacc	FALSE
aabbcd	FALSE
babccbdabcdcabcadaabcbcab	FALSE
dbccaddccccdcdbbadba	FALSE
bcadccbaacdddaaccbbaadcab	FALSE
bcdbcdbddbdbab	FALSE
bdccacab	FALSE
dabccbdaacbbacdcbcbadc	FALSE
bbaaaaaaaddadcccaccccbd	FALSE
adcbaaccad	FALSE
bdadbcd	FALSE
bdccab	FALSE
aabbcccbbccbdaaccd	FALSE
adaabaaddcbaadabdccdacba	FALSE
dabbddacaababbdddcbacb	FALSE
acbbcbddbacaccbcdcadbacbd	FALSE
dadccacbcbad	FALSE
adcdbbbabddbb	FALSE
babdccc	FALSE
badbabaadbcdc	FALSE
ddbdcadaabaaddcbaadabdc	FALSE
bdbbcbdcbdabdb	FALSE
dddcabbcbccdb	FALSE
ddacb	FALSE
dadacccb	FALSE
cbbdcccbddab	FALSE
acabdcddbdcadab	FALSE
abcdccaabbcddbbcdcdabbb	FALSE
abbcccbbccbdaaccdcb	FALSE
bdbddcdbbbcbcbdbccab	FALSE
bdbbcbdcbdabdbabb	FALSE
abbcddbbcdcdaba	FALSE
cdccbacdbabb	FALSE
dbbbcbcbdbccabcd	FALSE
aabdbbacdacbccacbacdbaa	FALSE
ddcbbadddabadb	FALSE
ddabdacbbdcdc	FALSE
ccbddcacdbbaaaccbacccccad	FALSE
dbdaccdaccbbaaaaaa	FALSE
bacabcadabccbdaad	FALSE
adaccdbaabdcaabdbbacda	FALSE
cbabdcccca	FALSE
dabdccdacbaacbbbccb	FALSE
baddcbdcacbbccbbacbbbcbaa	FALSE
cacbcbadcbb	FALSE
ccaababbdacdb	FALSE
dbcdcbabb	FALSE
cccdbdccbbab	FALSE
bdabacdabbddddbdbdbbbab	FALSE
adcbadadbbacdccddcb	FALSE
cadb	FALSE
caaabadcbab	FALSE
dbdbbccadcadacdcdaabaaadc	FALSE
cdacbdcdabbddacbb	FALSE
cdcdbdaccdaccbb	FALSE
acbddc	FALSE
accaaadcdcaddcdbccaaddcca	FALSE
babb	FALSE
cdddcdbbdabb	FALSE
bdacbbdcc	FALSE
bdbbdbcdbcdcdbbbbcbcdcabb	FALSE
aaaaddadcccaccccdbdcbddd	FALSE
aaaaddadcccaccab	FALSE
ccbbccbdaaccdcdbdaccdac	FALSE
acaccabaacadcdcddcacabdab	FALSE
cdadacccb	FALSE
bcbadcbcd	FALSE
cbbbccadaccdbaabdcaabdbb	FALSE
ddaabdcbabbdccadbcccbbb	FALSE
dbbabcbcdcbcbbb	FALSE
cabcdccaabbcddbbcd	FALSE
bababb	FALSE
cbdbaabbddbacdcccaddabbbb	FALSE
aabbdcbcdbaaabad	FALSE
abca	FALSE
adcbadadbbacdcccbbcdbb	FALSE
dbdbbab	FALSE
cacadcaab	FALSE
cbbbadbb	FALSE
acaddacddadbabdabacdbbbab	FALSE
dcab	FALSE
dbaddadcbcbbcacaccabaa	FALSE
abbcddbbcdcdabcdbcdbddbb	FALSE
ccadcdbbbbb	FALSE
ccdddacb	FALSE
aacadadb	FALSE
abbbbbdbbdcddddcbaad	FALSE
dacbdcdabbddacabdb	FALSE
dccdbaddadcbcbbcacacc	FALSE
adaaacacadccdcddbcbbdaaba	FALSE
cbccbcab	FALSE
ccab	FALSE
ccab	FALSE
babbdacd	FALSE
accadba	FALSE
dabcdbcdbddbdbadc	FALSE
ccbbccbdaaccdcdbdaccd	FALSE
bdbbcbdcbdabdbabadcaac	FALSE
dddaddccbbb	FALSE
adbccaddccccdcdbbadbaa	FALSE
cbbcdbbabcbcdb	FALSE
dcbadadbbacdccd	FALSE
adcdaadcbcabcdccbdcaccaaa	FALSE
accdadbbdaddbadbddb	FALSE
bbabd	FALSE
adcbadadbbacdcccbbcadcb	FALSE
acacaaccbdcadcbabcaadbcdb	FALSE
badccbdbdbbacad	FALSE
ddbdcadaabaaddcbbc	FALSE
cbbacdcbcbadccdbaddadcba	FALSE
adbabcacaddccbacccdadbacb	FALSE
baadcbadadbbacdcccbbcdbb	FALSE
bbcbcab	FALSE
bababbbca	FALSE
abadbabaadbd	FALSE
accdabcb	FALSE
dbcdcbbdbab	FALSE
ccaab	FALSE
aabbcccbbccbdaac	FALSE
aaabaaa	FALSE
aacadab	FALSE
ccaababbda	FALSE
cadcdbbbb	FALSE
baabb	FALSE
cbdaaabbcccbbc	FALSE
aabbadbcbabcbaadcabdaddba	FALSE
cacbddc	FALSE
abcdcab	FALSE
dccbbdcaadadaccdabcabbbbb	FALSE
abcdacadbbdcaaccbaadccabb	FALSE
aaadbbabcbbcbbdbaaadbdbad	FALSE
dcdbdaccdaccbbaa	FALSE
cadcdaaacdcddabbcbbdbcaaa	FALSE
cbdbbcbdcbdabdbabaaba	FALSE
dcadcb	FALSE
dbdbaccbaabbaddbaddcbbaca	FALSE
abdcbabbdccadbcccbbbccbc	FALSE
ccabca	FALSE
bdcccbdcabaccccddacddbcaa	FALSE
dabcdbcdbddbdbadcb	FALSE
bcbadccdbaddadcb	FALSE
bbdbbab	FALSE
ddbab	FALSE
ddbab	FALSE
addcbbadddaabbbbbdbbdcddb	FALSE
bcdadbbbadbcaadaaaabcabbd	FALSE
cabbcadbaddaabcacdbbdbdab	FALSE
aaaaaddadcccaccccdbdcbddd	FALSE
ddccccdcdbbadba	FALSE
cabccdaabcccdcbdabcbcaccb	FALSE
ccdadbbdaddbba	FALSE
dbccaddccccdcdbbadbaabbb	FALSE
bcbbcacaccabaacad	FALSE
cddddaddbbdab	FALSE
ccdaddb	FALSE
dcbcaccdadbbdaddbadbb	FALSE
ddabdacbbdc	FALSE
ccddccbcbcdbdcaddaccdcaab	FALSE
bcbcdcbcaccdadbbdadbba	FALSE
abab	FALSE
caddccccdcdbbadbaa	FALSE
accdadcdbcb	FALSE
dcabadbaba	FALSE
bccacbacdbaacbdaacbaba	FALSE
