adcbbdcddacddbbc	TRUE
ddddbcdabcbbddda	TRUE
cbddcabbcababdca	TRUE
addccacabcbad	TRUE
babbaddd	TRUE
dddabaacbdccb	TRUE
cbdc	TRUE
cadabcdcaa	TRUE
addbcccba	TRUE
cadabcdcaaadbbd	TRUE
ddcaaabccdadcbcbabb	TRUE
bdaacddadbcddbc	TRUE
dcbbbb	TRUE
bdcaacabbbaddcaab	TRUE
aababbdccaba	TRUE
ddd	TRUE
ddddbcdabcbbb	TRUE
bccddbdadcadadaca	TRUE
dddabaa	TRUE
bcbbc	TRUE
bdaacddadbcda	TRUE
ddcaababbdcca	TRUE
babbdccaabdaacbcdd	TRUE
bdccdddabcdbbac	TRUE
dcdcd	TRUE
acacdcb	TRUE
cdacdcdcadd	TRUE
cccdcbbddbacdacccca	TRUE
abb	TRUE
abb	TRUE
dacdcd	TRUE
adcbdabdbbb	TRUE
ababdcaacbdd	TRUE
dbcddbccdddbdb	TRUE
dbdbaa	TRUE
baacbdccdddabcdbb	TRUE
bcdbbaccbcbbc	TRUE
adcbdabbbb	TRUE
bd	TRUE
bd	TRUE
bb	TRUE
bb	TRUE
bb	TRUE
bb	TRUE
aaaaba	TRUE
dccdacdcd	TRUE
ccadcbaadcbbdca	TRUE
dabbcbd	TRUE
cdacdcd	TRUE
ddddbcdabcbbdddcbbab	TRUE
bdc	TRUE
bdcddcbabb	TRUE
ddddcbba	TRUE
dca	TRUE
dca	TRUE
bababd	TRUE
acdcbadbcbddbd	TRUE
acacdcbadbcbddbdadc	TRUE
dcbaadcbbdcdda	TRUE
aababbdccaabdaacddb	TRUE
ccabaabac	TRUE
ddbccddddbcdabcbbdb	TRUE
bcdbbaccbcbdbbbccc	TRUE
dac	TRUE
bbbddacad	TRUE
ddbdcaaaca	TRUE
aa	TRUE
aa	TRUE
cddddcbba	TRUE
abbbddac	TRUE
acdddd	TRUE
dcdabbcbdcddb	TRUE
ababdcaacabbdddbbbbc	TRUE
dcaaadbbdabacabcddbdb	TRUE
dadacccdbdbaaab	TRUE
adabcdcaabb	TRUE
babbadadacccdbdbd	TRUE
dbbacdbc	TRUE
daccddaaaddccacbdb	TRUE
abcddbdca	TRUE
adbdbbababcaddadbb	TRUE
bbba	TRUE
abdbcdddabb	TRUE
acddddcbdbbdaadcbd	TRUE
adcaaacbacacccdaba	TRUE
bbdccaabdaacdd	TRUE
acba	TRUE
dadacccdbdbaaaddbcab	TRUE
dddab	TRUE
dddab	TRUE
ddcbabb	TRUE
dbbadb	TRUE
cbdccdddbdb	TRUE
cddddcbdbbdaabbb	TRUE
bbadddabaacbdccddbb	TRUE
aaddbcccbdd	TRUE
badccadcdcbccc	TRUE
dcdcdabbcbdcddcb	TRUE
bbcbdcddcbabbaddd	TRUE
ccadcbaadcbbdcddacdd	TRUE
ccabaab	TRUE
dadacccdbdbaa	TRUE
bdbdcba	TRUE
bccddbdadcaddbbbbbd	TRUE
badabcbacbbdcacadcaa	TRUE
dcbdabbbb	TRUE
cabadbdbcb	TRUE
ad	TRUE
ccbddcabbcababd	TRUE
cabcddbdcaaacacd	TRUE
caccbbcaaa	TRUE
bddcabbcababdcaacbb	TRUE
cabbbaddcbd	TRUE
cdbc	TRUE
adaba	TRUE
adcbdabdbbbc	TRUE
ccbdddca	TRUE
dbbccdca	TRUE
bcdbbac	TRUE
acddadbcda	TRUE
ddddcbdbbdaabbb	TRUE
adbbdab	TRUE
badbdababdbd	TRUE
bdbbbcccabadbdababdbd	TRUE
ccabadbdababab	TRUE
aaadbbdabacabcddbd	TRUE
bddbdadccdacd	TRUE
dadacccba	TRUE
dd	TRUE
dd	TRUE
dd	TRUE
acaa	TRUE
bbcbdcdd	TRUE
abbcababdca	TRUE
abcdaa	TRUE
aaaca	TRUE
dbcbdad	TRUE
baacbdccdddabcdbbaccb	TRUE
bbdccaabdaacddadbcda	TRUE
cddaaaddccacabcbadc	TRUE
dacdcdcd	TRUE
bacaccbbcaaa	TRUE
dcba	TRUE
aababbdcc	TRUE
dbdaccddcaaabccab	TRUE
dacd	TRUE
dacccdbdbaaaddbcab	TRUE
caccbbcacbdca	TRUE
bcbdbbb	TRUE
bbd	TRUE
ddbccddddbcdabada	TRUE
cddaaaddccacab	TRUE
dbdbaaab	TRUE
ddaadbdbbababcb	TRUE
bdbcdacc	TRUE
adbdbbababcaddadbbdd	TRUE
bcdbbaccbcbdbbbc	TRUE
acacdcbbd	TRUE
bbcbd	TRUE
cabbbaddcaababbb	TRUE
bdbbdaadcbbbb	TRUE
dcdcdabbcbdcddcbbbaa	TRUE
cddddcbdbbd	TRUE
cddaaaddccacbdb	TRUE
dbbac	TRUE
dadacccdbdb	TRUE
ddcaaabccdadcbcbacdd	TRUE
b	TRUE
b	TRUE
b	TRUE
b	TRUE
b	TRUE
b	TRUE
b	TRUE
b	TRUE
b	TRUE
b	TRUE
b	TRUE
b	TRUE
b	TRUE
b	TRUE
b	TRUE
b	TRUE
b	TRUE
b	TRUE
b	TRUE
b	TRUE
b	TRUE
b	TRUE
b	TRUE
b	TRUE
b	TRUE
b	TRUE
b	TRUE
b	TRUE
b	TRUE
b	TRUE
b	TRUE
b	TRUE
b	TRUE
b	TRUE
b	TRUE
b	TRUE
b	TRUE
b	TRUE
b	TRUE
b	TRUE
b	TRUE
b	TRUE
b	TRUE
b	TRUE
b	TRUE
b	TRUE
b	TRUE
b	TRUE
b	TRUE
b	TRUE
b	TRUE
b	TRUE
b	TRUE
b	TRUE
b	TRUE
b	TRUE
b	TRUE
b	TRUE
b	TRUE
b	TRUE
b	TRUE
b	TRUE
b	TRUE
b	TRUE
b	TRUE
b	TRUE
b	TRUE
b	TRUE
b	TRUE
b	TRUE
b	TRUE
b	TRUE
b	TRUE
b	TRUE
b	TRUE
b	TRUE
b	TRUE
b	TRUE
b	TRUE
b	TRUE
b	TRUE
b	TRUE
b	TRUE
b	TRUE
b	TRUE
b	TRUE
cbdccddbb	TRUE
dcbdabdbbbcabdbcb	TRUE
bcdcaaabb	TRUE
dcaa	TRUE
cbddcabbcababd	TRUE
dadacccdba	TRUE
acacdb	TRUE
adabcdcaaadbbdab	TRUE
bdccdba	TRUE
cddbdadcaddbbbbbcdac	TRUE
dcbbd	TRUE
dcab	TRUE
ddadbcddbcbb	TRUE
cabcddbdcaa	TRUE
dbbdabac	TRUE
babbadddabaacbcdbb	TRUE
dbbccd	TRUE
bdcddcbabbaddd	TRUE
dab	TRUE
adab	TRUE
acdcbadbcbddbdadccda	TRUE
bdccd	TRUE
cabab	TRUE
acabbbadd	TRUE
cddaadbdbbababcadac	TRUE
ccbbcacbd	TRUE
dbbccdcacdbd	TRUE
dabcdcaa	TRUE
ddbbbbbcdacca	TRUE
bacabcddbdcaaac	TRUE
cddcbadabcbacbbdca	TRUE
bddbdadccdacdcdcd	TRUE
ccbbcacbdccdcadbbca	TRUE
badbcbddbdadccda	TRUE
dabcdcaaadbbdabac	TRUE
ababdcaacabbdddbbb	TRUE
dadacccdbdbaaada	TRUE
bcddbdca	TRUE
bdccdcadbbccdca	TRUE
dbbccdcacdddd	TRUE
aacabbbaddcabca	TRUE
adbbc	TRUE
bbcababdc	TRUE
cdcbadbcbddbdad	TRUE
aaddccacabcbadcdb	TRUE
bacbbdcacadcaaacbac	TRUE
dcd	TRUE
ababbdccab	TRUE
cabcdaa	TRUE
babdbd	TRUE
bacacb	TRUE
dcbdabbc	TRUE
bbbddac	TRUE
bdbbdaadcbabbd	TRUE
bdca	TRUE
cdacdcdcdabb	TRUE
cddddcbdbbdaadcbbbb	TRUE
cd	TRUE
cd	TRUE
cdcbadbcbdad	TRUE
bccddbdadcaada	TRUE
dacccdbdbaaada	TRUE
aacacdcbadbcbddbdadca	TRUE
cdcadbbca	TRUE
dbbc	TRUE
abbcababdc	TRUE
dddabaacbd	TRUE
baba	TRUE
bbb	TRUE
bbb	TRUE
caccbbcacbdccdba	TRUE
bbdccaabdaacddadb	TRUE
dbbccdcbbd	TRUE
bccddbdadcaddbbbbb	TRUE
dccdacdcdb	TRUE
aaa	TRUE
ddaadbdbbababcadd	TRUE
abdaacddb	TRUE
ccabadbdbcb	TRUE
bdbbdaadcbdabdbbbbbb	TRUE
ddcbb	TRUE
ddaaaddccacabcbadcdb	TRUE
ccabab	TRUE
dcdb	TRUE
caabdaacddadbcda	TRUE
adabcdcaaadbbd	TRUE
baacbdccdddbdb	TRUE
dacdcdcdabbcbdcddcb	TRUE
cbacacccdcbbddbacdac	TRUE
dbbaad	TRUE
dadacc	TRUE
aaacacdcbadbcbddbd	TRUE
caabdaacddb	TRUE
acbdc	TRUE
dbbd	TRUE
accbbca	TRUE
ddbcccbddcabb	TRUE
bccddbdadcadbcda	TRUE
dccadcdcbcccadcb	TRUE
bdccdcadbbccdcacdddd	TRUE
dabbcbaba	TRUE
ccbcbdbbbcccabaab	TRUE
ccddcaaabccdadcbcb	TRUE
dcbadbcbdb	TRUE
ccacabcdaaddcdbcabdb	TRUE
bcdcaaadbbdabacabbd	TRUE
dbbdabacab	TRUE
addbcccbdd	TRUE
dccdacdcdcdabb	TRUE
cdddab	TRUE
cdacdcdcdabbcbd	TRUE
ccadcbaadcbbdcddaa	TRUE
baad	TRUE
ca	TRUE
babbadddaba	TRUE
bbabccddbdadbda	TRUE
dadacccdbdba	TRUE
ddbccdddbdb	TRUE
baacbdab	TRUE
dccda	TRUE
d	TRUE
d	TRUE
d	TRUE
d	TRUE
d	TRUE
d	TRUE
d	TRUE
d	TRUE
d	TRUE
d	TRUE
d	TRUE
d	TRUE
d	TRUE
d	TRUE
d	TRUE
d	TRUE
d	TRUE
d	TRUE
d	TRUE
d	TRUE
d	TRUE
d	TRUE
d	TRUE
d	TRUE
d	TRUE
d	TRUE
d	TRUE
abcdb	TRUE
bdbcdddababb	TRUE
bbabccddbdadc	TRUE
bdccdddabcdbbaccbacc	TRUE
addbcccbddcb	TRUE
dbbccdcacddddcbba	TRUE
ddddbcdabcbbddd	TRUE
cacaa	TRUE
bcb	TRUE
bacaccbbcacbdccdcadbb	TRUE
bacabcddbdcaaa	TRUE
dadacccdbdbaaaddbcc	TRUE
bddbdadc	TRUE
c	TRUE
c	TRUE
c	TRUE
c	TRUE
c	TRUE
c	TRUE
c	TRUE
c	TRUE
c	TRUE
c	TRUE
c	TRUE
c	TRUE
c	TRUE
c	TRUE
c	TRUE
c	TRUE
c	TRUE
c	TRUE
c	TRUE
c	TRUE
c	TRUE
c	TRUE
caccbbcacbdccd	TRUE
aaadbbdabacab	TRUE
cacdcbadbad	TRUE
abdb	TRUE
badbdababdbdcbacacaa	TRUE
bddbdb	TRUE
acbdca	TRUE
cdcadbbccdc	TRUE
cabadbdababdbdcb	TRUE
aacabbbaddcaab	TRUE
bbadddabaacbdccb	TRUE
bdcddcbabbab	TRUE
ddcaaabccdadcbcb	TRUE
acacdcbb	TRUE
add	TRUE
add	TRUE
badbdababdbdcbacac	TRUE
dccdacdcdcdabbcbdd	TRUE
addbcccbddcabbcab	TRUE
bdabbbb	TRUE
cabadbdababab	TRUE
bdbdcbacaccbbca	TRUE
adbbccdcacdddd	TRUE
ccbcbdbbbc	TRUE
acabbbaddc	TRUE
ddbdcaaacacdb	TRUE
adabcdcaaabb	TRUE
baaa	TRUE
abcddbdcaaac	TRUE
caccbbcacbd	TRUE
bdccddd	TRUE
ccbcbdbbbcccabaabac	TRUE
aaaba	TRUE
cddaaaddccacabcb	TRUE
baa	TRUE
cdddabcdbb	TRUE
ccbbcaaa	TRUE
db	TRUE
db	TRUE
db	TRUE
dabcdca	TRUE
bccddbdadbd	TRUE
bdbdcbacaccbbcaaa	TRUE
bdbbda	TRUE
ccbcbdbbbccc	TRUE
ccadcbaadcbbdcdda	TRUE
cdddaad	TRUE
ccbcbdbbb	TRUE
ababdcaacabbd	TRUE
baacbdccddbb	TRUE
abcdaaddcdbcabdabdc	TRUE
ddbb	TRUE
bcddbdcaaacacdcbb	TRUE
babab	TRUE
adcdcbcccadcbaadadd	TRUE
dcdcdabbcbdcddcbabbab	TRUE
bdbbbcabdbcdddabbd	TRUE
ddcbabbadddabaa	TRUE
adbbdabacabcddbdbdbb	TRUE
bbcacbdccdcadbbccd	TRUE
ccb	TRUE
cabaabac	TRUE
addbbbbbcdac	TRUE
bbabccddbdad	TRUE
bcbdbbbcccabaab	TRUE
cbcadbbaabba	FALSE
bddcdabbaacbbaa	FALSE
cdabcacbcaaddbcaddabccda	FALSE
bdaadccbbaabba	FALSE
ddabbbbaabbba	FALSE
bbcbbcdaabbabaaadabbadcaa	FALSE
ddcdaccabbdddbbcbbacababa	FALSE
dacddcdacbcbbdccbcbdaabba	FALSE
babdaadbcdabacddddacadbba	FALSE
dcbdcdadabbaabba	FALSE
addadcbdcdbaababa	FALSE
dbdabacdbabccdabbba	FALSE
ddabccbbabbdbdabba	FALSE
dbdcbadcbcdacaabbabadbaba	FALSE
dccbdcddaacaabbaabba	FALSE
ababcdbcbcbdaccbbbbaabbac	FALSE
abbbdcbdbdacccccddabba	FALSE
aaabcbdcbbddadcbbbbdbabba	FALSE
abdcddddbdcbbdaacccbbda	FALSE
cbaadbbaabba	FALSE
bbbaddddcbbacccddddcaabba	FALSE
bdaadccadadbbaabba	FALSE
acbbadabba	FALSE
dcadbcdbadbcdabba	FALSE
dbadbacbddcbddbcbcbdaabba	FALSE
ddabcbaacbaadbccabbacb	FALSE
dccaddddadacadcbcdabaabba	FALSE
bacadcadbcdbadbabba	FALSE
bcadbbddcabcabbbbbabdadca	FALSE
dbdabacdbabccdabcacbca	FALSE
ccaadadddaabbccbaabdba	FALSE
cccadcdbdbaabba	FALSE
bdbbababdcabcccaabababacb	FALSE
dabababcabdbab	FALSE
abbbaadabba	FALSE
addbbaccddbccdcdabdbbcdba	FALSE
bcddbbcadbccddacdbcbaabba	FALSE
dadaaabbbaaddabba	FALSE
adbbaabba	FALSE
adbbaabba	FALSE
dadbbbbbbccdbdacdabbaadac	FALSE
cddacddbbaabba	FALSE
aaacbddcaabcbbccdadadbaba	FALSE
dbdbadddaabaddadcabbaabba	FALSE
cccadcdbcabdbdddcadababab	FALSE
dababaabba	FALSE
badccadddbbacdadcdbba	FALSE
daaabdbabccaccbbacbbcbcdc	FALSE
bbcaadcdcccdadadcbbdaabba	FALSE
badbbaabba	FALSE
badbbaabba	FALSE
babbdabbaadacabba	FALSE
bdcbccdbcbadccadbbaabba	FALSE
dbaadadcccdbbbbacdaadbbda	FALSE
daadbbddbcbbcdaacabacadba	FALSE
dbbcbddccdaddbacbadcbabba	FALSE
cdabddcdddbaabba	FALSE
aacdcdcbcddcdbabdcacdbbba	FALSE
bccbcdcbbcbaacddddbbaabba	FALSE
bacadbdbaabba	FALSE
ccbdccacbabbbdbcbdaacbdba	FALSE
cdabcadcbdcabaacdbaaabadd	FALSE
bccbbabbdbaabba	FALSE
adbcdbadbcdaaadababbdabba	FALSE
bcbdcddbdbcbbadbbddbaabba	FALSE
dccbadbcbdaabba	FALSE
dddbaaddabccbbabbabba	FALSE
dcacbcacbbbadaccbacdba	FALSE
bbaadacababaacacadcbbba	FALSE
abdcddddbdcbbdaabdba	FALSE
dcbddccddbdbcdbcbabbaabba	FALSE
ccbaccdcbccccddbdddaababa	FALSE
cbabbaabba	FALSE
cbabbaabba	FALSE
bdbadcbdabaaabba	FALSE
ddbabbdaabba	FALSE
adcdaaabaccdcadddbaddabba	FALSE
bcbabbabacadddccacaddbaba	FALSE
baadbccabbacdbabdaadccba	FALSE
abbbaaddabcbaacbaadbccabb	FALSE
cddacdcacbcabaabba	FALSE
bbbdcbabbaabba	FALSE
ddbadaddbddcccabbcacaabba	FALSE
ccbacdbdbaabba	FALSE
badbcccbacdcacaadbbacbaba	FALSE
bdbdadccdcaaaaabbaadcabba	FALSE
bdcadaddadaacbaddabdaabba	FALSE
bddcbdbaacbbabdadadbdabba	FALSE
daaccabddbdcbddccbdbaabba	FALSE
cabcddddbacadbabcbcaacbad	FALSE
bdbabdbbbbdaacccccabdbabb	FALSE
bdbdddcadabababcabdcaaba	FALSE
ccbacdbdcacbdaabba	FALSE
ccadcdbcabdaabba	FALSE
adbcdbaabba	FALSE
ccbcadbbaabba	FALSE
bcadacdcbbbbbdbccaacababa	FALSE
adddbbacdadccbaba	FALSE
addadcbdcdadadcdddbaababa	FALSE
cadbbaabba	FALSE
bbccacbbccaddbccaccbbbcaa	FALSE
bdbadbbccdacabdcabbcbabbb	FALSE
cdbbacbbaabba	FALSE
bdccccdddbabbaabba	FALSE
dabdaacddddacaccbbbdaabba	FALSE
dabdbaabba	FALSE
bcabdcbbaabba	FALSE
cdbabdaadccadadddbcaaabba	FALSE
aacbddbcaddbdbacdcabacbca	FALSE
abdcddddbdcaabba	FALSE
cccdadadbcdbccabcdcaabdba	FALSE
babaaaacbcbabdcbabcbdbcac	FALSE
adddadbbaabba	FALSE
adcabdcbccdbcbadacbaba	FALSE
cbdcbacbddacacbcadacabbab	FALSE
ccccddacddbbaabba	FALSE
ddcdababaabba	FALSE
acdaaccccacadcdddbbbaabba	FALSE
acabbccaacabacaaaccadabba	FALSE
adcadbcdbadbcdaaadbaba	FALSE
dddbaaddabccbbbaabba	FALSE
dccdbdacbdbccbcdcaabbabdd	FALSE
bcabaddbabdcdacdcbbbacbab	FALSE
dbcdaaadababbaabba	FALSE
abddcadadbdcdabcddbdababa	FALSE
ddacdcacbbaabba	FALSE
dddbaabdbaabba	FALSE
cadcdbcabdbdaabba	FALSE
babcbadabba	FALSE
aaccbbaabba	FALSE
adabababcabdcddddbaddab	FALSE
acbcacbbbadacdbba	FALSE
bcacbbbadaccbacdbda	FALSE
aaaaadbbddccddacadddabdba	FALSE
acbabaabba	FALSE
ddacddcdbbaabba	FALSE
dccadddbbaabba	FALSE
abbddadcbcbcdbbcbdcbdabba	FALSE
dcccaadadddaabbccbaabba	FALSE
bdcbccdbcbadccadabbaabba	FALSE
bbcbadbdbcdbdaaadbbcbabdb	FALSE
bdbdddcadabababcabdbab	FALSE
cabbacdbabdaadccabba	FALSE
dadadcdddbaabdbaabba	FALSE
adcdbcabdbdddbaabba	FALSE
bdcbbabbaabba	FALSE
ddddbdabbaabba	FALSE
dadbcadcadbabaacccabddbaa	FALSE
ddabadbcaaccbbabddadadaad	FALSE
cadadddbcabadabba	FALSE
acacadcbbaabba	FALSE
cbdcbdadbdcacdabadcbabbba	FALSE
acadcbbbacddabba	FALSE
dbbabbaabba	FALSE
dbbabbaabba	FALSE
bcddabcadcbbcdabddbdababa	FALSE
cdbaadbbadcccaadadddabba	FALSE
aabbdcbbcacacabaccaddabab	FALSE
aaacbdcbbaabba	FALSE
dadddaabbccbaabcbcbdaccab	FALSE
ccbabbaabba	FALSE
adadadcdbbcaaaccaccadabba	FALSE
cccdccdadbcdcdbbccacaabba	FALSE
dccbdcddaabbababba	FALSE
ddbaacbbcbcdadadcabbad	FALSE
dbbcaddbabaabba	FALSE
cbcdddbaaddabccbbbaabba	FALSE
dabddcddddbaababa	FALSE
ccaadbbaabba	FALSE
bcddabbdcbcaccabbaddddbbd	FALSE
acbbaabbaa	FALSE
cabbaabba	FALSE
cabbaabba	FALSE
dabcaddacbddacaadcdcacbba	FALSE
acabdcddddbdcbbdaabdba	FALSE
adccadadddbcaaacbbaabba	FALSE
bcadccbbaabba	FALSE
dcadbcdbadbabba	FALSE
bdcbbbadbbcaaaabba	FALSE
cbaabcbcbdaccdbdabacdbab	FALSE
babbadbdcdaaabadadabacdab	FALSE
daccbabbcabaccaccddabddba	FALSE
adcabdcbcaabba	FALSE
ccdadcdddbbddbaddacdabbba	FALSE
daacabbbbadaaaddcddadbbba	FALSE
abdcddbbabbddacddcdbdabca	FALSE
cddcdadddccdabddcbababba	FALSE
abcdadaaabbbaadbba	FALSE
dacababaabba	FALSE
ccddacddcdadbbaadbba	FALSE
bcdddbaaddabccbbabbbabba	FALSE
aacbdcbbbadbabba	FALSE
ddaacbbbaabba	FALSE
caaddadcbdcdadadcbcaabba	FALSE
bbddccccbcabaadaabcdaabba	FALSE
caddccbabacacbadddaaabbba	FALSE
cddabbbbccdaabba	FALSE
bbdbbaaababbbacbdbcbbabba	FALSE
acbdcbbbadbbcaaabba	FALSE
bdbadcbdadabaabcdadbba	FALSE
ddbdccddabbbbaabbba	FALSE
adbdbbcaddbaabdadaaabcbba	FALSE
adbaccddaacaaabddabbdabba	FALSE
bcddacdbbcdbbaaddcabba	FALSE
bdadabaabcdadaaabbbaadaa	FALSE
abdcddddbdcbaabba	FALSE
bdbcbcadccbaddbddbaabba	FALSE
bbdabbaadacababaacabb	FALSE
bcbdaccabbaabba	FALSE
bdcdddabbcccccbdadaacbbca	FALSE
dbbadcaabdbacbdabbdbdcdac	FALSE
dbabccdabcacbcaadbaba	FALSE
cddacddcdababaabba	FALSE
dcdddbaabdbcbcaabba	FALSE
adbccaaabddaabcdababadabc	FALSE
dbbcccaadacccdbdaabaabcba	FALSE
baddbdccddabbbbccaabba	FALSE
bdcbcbcdabbaabba	FALSE
acbaadbccabbaabba	FALSE
adcabdcbccdbaabba	FALSE
dbcbadccadddbbacdadccbaba	FALSE
cdadccbdcddabbaabba	FALSE
baddbdccddabbbbcacccabba	FALSE
cdabdbaabba	FALSE
cccddacddcdadddbdbaabba	FALSE
bbacbaddacddacddaabbaabba	FALSE
adcadbcdbadbabba	FALSE
babbaabba	FALSE
babbaabba	FALSE
babbaabba	FALSE
babbaabba	FALSE
babbaabba	FALSE
babbaabba	FALSE
cbcabcbbaabba	FALSE
bdabbaabba	FALSE
abddabaddcaadbcbcdbbdaaab	FALSE
dbadcdcbdccbbcbbaabba	FALSE
dabababcabdcaaba	FALSE
abcbaaaddaddccadccadadbba	FALSE
cbabddbaabba	FALSE
abbbaaddabcbaa	FALSE
bbbadbbcaaaccbcdddbaaddab	FALSE
adbbababba	FALSE
dbccabbacdbabbba	FALSE
dbbbbcabbbdcaabba	FALSE
dabaabaabba	FALSE
dddaddbaacbbcbcdadadcbba	FALSE
dadddaabbcaabba	FALSE
abbbaabba	FALSE
dababbdabbaadacabba	FALSE
dcbacbbdabaaadadccaddbbca	FALSE
babcaaaddcacbcbcacabbbaaa	FALSE
dadbaacddaadacbbcaaadbcba	FALSE
babaacacabaabba	FALSE
bbbddcdddcbbcaccadbbaabba	FALSE
aabbaabba	FALSE
aabbaabba	FALSE
aabbaabba	FALSE
baacdcdbcbbdaabbdbacdccad	FALSE
babbcaabba	FALSE
addcadddaddbabadabba	FALSE
bdbadcbdadabaabcdadabab	FALSE
abdbabccaccbbacbbcbccbb	FALSE
cccadcdbcababababa	FALSE
bbddcabdaabcccbdbcccaabba	FALSE
addcadddaddbabaabba	FALSE
aadaabbadbbbdbdcabccaadba	FALSE
baacbaadbccabbabba	FALSE
abacdbaadbbadcccaadab	FALSE
dbddcacbabdcbddaaadcbdbca	FALSE
caaddbbaabba	FALSE
cbbcbcdadadcaabacdbaaabba	FALSE
cbdcdbaabaddbdcabdbdcabba	FALSE
adadbbaabba	FALSE
cccdddcbcddacbbaabba	FALSE
ddabbababba	FALSE
aadddadcaaadddbbababdbcab	FALSE
dadcabbaabba	FALSE
baadbbaabba	FALSE
bcabdcdddbaabba	FALSE
acacadcbbbacddacbba	FALSE
dcabacbaabba	FALSE
dababbdabbaaabba	FALSE
dbabdaadccadabaabba	FALSE
bdcbddbcdabdbdbddccadabba	FALSE
bbacbdaabcdccddacbaddbbba	FALSE
addadcbdcdadadcbcaabba	FALSE
abbbdcdccacbbabbcbabcbcda	FALSE
adacdcccdacdccdaabbadabba	FALSE
adbdddbccdbcbdaacbdcddbad	FALSE
ddcbcbbdacdadbbdbabdcabba	FALSE
dacababaacacadcbba	FALSE
bbcbcdadadcaabacdbaabba	FALSE
ddbbabbaabba	FALSE
cabdcddddbdcbbaabba	FALSE
dddaddbaacbbcbcdaabba	FALSE
abcdadabaabba	FALSE
bdccccdabbaabba	FALSE
dbabdabdaabba	FALSE
cdadbccdddadbcdbadccbabba	FALSE
ccdddcadacbcadbdbacbbabba	FALSE
ccdddcbcddacbbaabba	FALSE
accbbacbbcbccbbcccbbabba	FALSE
cbaddbdccddabbbbcacccabba	FALSE
dcbddcacccabdbddabbdadbba	FALSE
dbadbcdbacabba	FALSE
abcbaabba	FALSE
abcbaabba	FALSE
dbcdaaadababbdababba	FALSE
aabdcdababbcbbcdbdccabcba	FALSE
dbabdabaabba	FALSE
dcadbcdbadbcdaaadababba	FALSE
daccbacdbaabbda	FALSE
bdbabddbaabbdcaacadbabbab	FALSE
cccdddcbcddacdbbcaabbaa	FALSE
dbabbdcabbccbbaabdbdccdad	FALSE
cdcacbcacbbbadacdbba	FALSE
babcbbacbcbacacaddababdba	FALSE
bcbaadcbbbaabba	FALSE
dbcbdccccdddbabbaabba	FALSE
dadadcabbadabba	FALSE
bddbababaacbbbabbcbcbbabb	FALSE
dadcccdabdccccadbabbbabba	FALSE
cddacdcacbcabcbbaabba	FALSE
dadadcaabacdbaaabba	FALSE
dcaabacdbaadbbadcc	FALSE
dcbbbabbaabba	FALSE
bdcabcbdbbbcbcbcdacabdbaa	FALSE
dbbcaaaccbcdddbaaddbba	FALSE
dacababaacacadcbbbacddacd	FALSE
acacadcbbbacdabba	FALSE
adadddbcaaacbdaaaabba	FALSE
cadcadbcdbadbcdaaabba	FALSE
ccdacdbcdbcdbaabbccdaddab	FALSE
bababaabba	FALSE
dabaabcaabba	FALSE
bddcabdddacbcbdcaaacbbcad	FALSE
bababcabdcddbabba	FALSE
acdacddaddbcccacdacbaabba	FALSE
bdcdbdaddcccbccbbabdcabba	FALSE
bcdadaaabbbaaddabcbaa	FALSE
ddaacaababaabba	FALSE
ccadcbcbaabba	FALSE
cbcadabcabbaddbcbbcadbcba	FALSE
abbddbbaaacbccbcaadbacaac	FALSE
acaabbaabba	FALSE
ddbcaddabccbababba	FALSE
dbbbdcbcdadadcbcdbbdaabba	FALSE
dcbbbbbcccbaaacbbbcadabba	FALSE
cbdcdabdbaabba	FALSE
adccadadddbcaaacbaabba	FALSE
acbbaabba	FALSE
cabaddccbcbbbdacadbddabca	FALSE
adacababaacacadcbbbaca	FALSE
cbaddacbcbdbcbcdbdbcaabba	FALSE
baadbccabbacdbabdaaba	FALSE
abbdbabdcabcdcddcababdbcb	FALSE
ccbcddbabbababba	FALSE
cbdbbcbcbddbacbbbddababba	FALSE
acddadcbccccacbccabaabbda	FALSE
cbadcdccbdcbbcdabbacbcaba	FALSE
bbddbabcaaddacadccbdaabba	FALSE
dababbdabbaabba	FALSE
ccadcdbcabdbdddbaabba	FALSE
bdaabaaababdddcdccbababca	FALSE
cbdccdbbcabdbcbcbdbababba	FALSE
bcbbadabacbddcdbbaababcad	FALSE
abaabdbcddbaadcaccddcbbac	FALSE
bbabbaabba	FALSE
abcdcccdaabbbbccbdacbabba	FALSE
bcaccddcacaddbddbcdbaabba	FALSE
dddbaaddabcdabaabba	FALSE
bdbabbaabba	FALSE
abbbbabadadbdccbdddddbabb	FALSE
ccdabdbaabba	FALSE
bacbbaaabba	FALSE
dbcbdccccabbaabba	FALSE
dacaadcbcbaccbbacdabcbdab	FALSE
adcacacbaadcdabbadddcabba	FALSE
dbabbcaabba	FALSE
addbcdbaacddcabbbcacacbbd	FALSE
dbabdaaabdaabba	FALSE
baadbccabaabba	FALSE
bcaaddbcaddabccdbaabcba	FALSE
caccbdbcbdbcddcacbddbabba	FALSE
baadbddcdbadcbdaacdabdaba	FALSE
dacbbbcabcddddbdbdcbcabba	FALSE
bdaccdbdabacdbabcbba	FALSE
dddbcaaacbdcbbbadbbcabba	FALSE
bccdbbcdacbcdadccbaaababa	FALSE
abcccdbbccdacdbbcbadcbbda	FALSE
baadabdcdbbacadbaadaccbda	FALSE
aadadddaabbdbaabba	FALSE
cbaddbdccddbaabba	FALSE
cbdabdcabbacbadccdbbacadb	FALSE
ddaadddccaddadcbcbdbaabba	FALSE
dabddcdbaadbba	FALSE
bdaccdbdabacdbabccdabca	FALSE
bcbaacbaadbccabbacdbaba	FALSE
ccbabaddaaaacbbababbdcbab	FALSE
adcdbcabdaabba	FALSE
cbaddbdbbaabba	FALSE
baddabcabbcdccdacbcadbaba	FALSE
addbddbcaccbadbddcbdcaabc	FALSE
dddcdadddbadcdcaacbaaabba	FALSE
ddddbadddabcbaabbab	FALSE
cbaddbdccddbcbacadbba	FALSE
cdbabccdabcacbcaaddbcbcda	FALSE
ddacdbbcdbbaaddcadddadbba	FALSE
dddcbdaadacbdbccdadcadbba	FALSE
bbabbdbdbadbcbdcccabba	FALSE
adacababaabba	FALSE
abdadbccdbbcdccbbcadbabba	FALSE
bdcddddbadbabaabba	FALSE
ccdddcbcddacdbbcdbbaabba	FALSE
bdbdddcadababbdaabba	FALSE
abccbaadbbdcaacabacbdbaad	FALSE
accbcdddbaaddbbda	FALSE
bbbaabbaabba	FALSE
addadcbdcdadadbbaabba	FALSE
dcbbabbaabba	FALSE
dcbbabbaabba	FALSE
cbaddbdccddbbcbaabba	FALSE
bdacbbbdaaabbddabababbcba	FALSE
ccbacdbdcacabdcdddaabdba	FALSE
addbdbaabba	FALSE
ddacdcacbcacbbbadacdbba	FALSE
dcabdcbccdbcbadababa	FALSE
ddddbadddabcbaadcbcba	FALSE
adcddccdcddcdbadadbadabba	FALSE
aadbbdaadddcdccdadbbbccad	FALSE
cadbabbcaadbdcadcacbcbcba	FALSE
ddbaacbbcbcaabba	FALSE
dddcbcdaabbaabba	FALSE
dacaacacdccbdabdadadbacba	FALSE
aacbdcbbbadbbcaaabba	FALSE
aadbbabdbcdaadcdcdcdcbbda	FALSE
cccabddcaabdccdaaabbdbdab	FALSE
ccabddcbdccadaabbcadddbdd	FALSE
bdccaacdcaadbbaddccabbdad	FALSE
abcbbaabba	FALSE
adbdbddcbaddcaababbdbabab	FALSE
dddaddbaacbbcaabba	FALSE
abbdaccaccdacaabbcdcbcabb	FALSE
cbcacbbbadacdbba	FALSE
cbbabbaabba	FALSE
adabbaabba	FALSE
dadddaabbccbaabcbba	FALSE
dabaaabdbaabbcabacabaccbb	FALSE
accacaabbadbcabddbdadacac	FALSE
ddabbaabba	FALSE
acbcacbbbadaccbacdbdcaadb	FALSE
dadddccdabddcdddbaabba	FALSE
bbbdcbacdbbaabba	FALSE
bdbcbcadcbbaabba	FALSE
abdcddddbadddabcbaadcabdd	FALSE
dadaacbcbdaacbaaaadadcbca	FALSE
ddabcbaacbbaa	FALSE
bddbbcbdbdbcddbaababaabba	FALSE
caadadddaabbccbaabba	FALSE
cacdcbabbdddbdcacbcacabba	FALSE
acdbcbaadabdadaabdbbbcbda	FALSE
acbdaddccdaadadadbbadabba	FALSE
bdbdacccccbbaacbbaa	FALSE
dccbdcddaacaaddbdbaabba	FALSE
aadabcdbdcacbcbabdbdbbbaa	FALSE
bdcabbaabba	FALSE
adbcdbadabba	FALSE
babbaabdba	FALSE
adbdacbbadcdcdaacbcbadbaa	FALSE
dccabdbbcaacabbabacbcacdd	FALSE
abbccbaabcbcbdaccdbdb	FALSE
cddcdadddccdabddcdbaadbba	FALSE
ccabcacccbddabbdbdadbabca	FALSE
dcdcbdccbbcdbcdaabbaabba	FALSE
adababbaabba	FALSE
abbbaaddabcbaacbaadb	FALSE
ccddbabbaabba	FALSE
bcbddcadacbcddaaddbacabba	FALSE
accbcdccbacbdbbaccdccabba	FALSE
cbdbcbcbbddbdccbaabbaabba	FALSE
ddabccdbadcdcbdbabba	FALSE
adcacdadbabbacaadaccdbcba	FALSE
cddcacadbcababccdabbcddab	FALSE
adccaaddabaabacccbabaabab	FALSE
bdbdbddcbabbbcaadcadbadba	FALSE
cacadcbbbacddacdcacbcbad	FALSE
ccbaacabdaaddccaccbababba	FALSE
bcdbaaabdcabcbcbaaabcbcba	FALSE
cdabddcddddababdadbba	FALSE
cdacbcbabcaacbcdaddddacba	FALSE
bdbdacbbaabba	FALSE
baddbdccdabdbaabba	FALSE
daaadababbdabbaadacababa	FALSE
acbcacbaabba	FALSE
bdaacddbcadddaddaaabaabba	FALSE
ddbcaabcdacbaaaaabddabcda	FALSE
cdcacbcabaabba	FALSE
cababaacacadcbbbacdd	FALSE
cbbabbdbdbadbcbdccccdabba	FALSE
