abbbbbbc	TRUE
d	TRUE
d	TRUE
d	TRUE
d	TRUE
d	TRUE
d	TRUE
d	TRUE
d	TRUE
d	TRUE
d	TRUE
cddcb	TRUE
ddadaccdbdcdb	TRUE
cabddcdadbbccbdbdbdd	TRUE
ddadadb	TRUE
bddaadbbddcbbdcbdc	TRUE
bbcdbcbcbddaccbdbdddcdd	TRUE
daccadccbcbbbdcbcccdcbdbb	TRUE
bddabac	TRUE
cba	TRUE
bddcdb	TRUE
ccadccbcbbbdcbc	TRUE
cdadbbcbccccbcdddc	TRUE
cabddcdadbbcdd	TRUE
abcbdbbcbccbdcd	TRUE
bddaadbbddcbbdc	TRUE
acdbcaadabddbc	TRUE
baacdcbcdbbbcbdddccbbcdbc	TRUE
babadcdcdbbbc	TRUE
cacdbbdcbccdbbddbcdcc	TRUE
cddabcdda	TRUE
ccadabdbddbdcddc	TRUE
bdcddc	TRUE
adccbabb	TRUE
cacbacdaccadccbdcbbdd	TRUE
abcbdbbcbcccbbbdcdcddbb	TRUE
bcdbaacabdbb	TRUE
ccdbdcdbadcdcacacdb	TRUE
cadcadaaddccdccbdbbcdbddd	TRUE
baca	TRUE
cbdbcdddbabddaadbbddbc	TRUE
cabbbbbbcdbbccbcdd	TRUE
bcadbbdd	TRUE
cdaa	TRUE
ddcccd	TRUE
acacdbcaadabddbbb	TRUE
ccacdcbbccbbdb	TRUE
cbabb	TRUE
dadbaacabccddcdbddbb	TRUE
abcabbcddbdc	TRUE
badcbbbbbbcdbd	TRUE
ddaccddabcddaad	TRUE
baacdcbcdbbbcbdddcbd	TRUE
dadcdaaccacdddd	TRUE
baccabdabdcbdbdcdcdbddccb	TRUE
bcdbaacabddcdadbbccbd	TRUE
accdcbdddcccbbbddb	TRUE
cacdbbbdbbdbcb	TRUE
dcbbb	TRUE
cdaadcdaccaca	TRUE
cacdcbbccbbddbdbbbdddbcd	TRUE
dbbdcdcdadcdaaccacdcbbc	TRUE
dddbabddaabdcb	TRUE
bcadbbdcd	TRUE
daabcbdbbc	TRUE
baccabdabdc	TRUE
ddaccddabcdda	TRUE
bacdaccadccbcbbbdcb	TRUE
abdbddcdbddbb	TRUE
daccacaadbbdcddcdbb	TRUE
ccabdabdcbbbd	TRUE
acdbcaadabbc	TRUE
acdbbbdbbdbcbdccccdbd	TRUE
cddaccddabcdda	TRUE
cbcccdbbdaadcaaaacaccadbd	TRUE
bdaccad	TRUE
bbdaddbddbbdcbbddbcdbb	TRUE
cdaadcdaccacabd	TRUE
aaccdcbdddcc	TRUE
dcdbdcdab	TRUE
dbdcdaddadaccdbdcdbdccbc	TRUE
cddabcddaadaabcdbcc	TRUE
bcdbbcbbddcbdaddbcbddc	TRUE
bbdcbbacacdbbbdbbb	TRUE
ddadadabdcddcaaccdcbbcbcd	TRUE
abbbb	TRUE
cdadbbcb	TRUE
acdc	TRUE
ddadadabd	TRUE
bbccddcacaaccaaddd	TRUE
adabdbddbd	TRUE
aaccdcbb	TRUE
dabdbddbdcddcbd	TRUE
cb	TRUE
dbddcbb	TRUE
bcacdddbdabbddbcbbbcbbbb	TRUE
cacbacd	TRUE
cdadbbcbcc	TRUE
ddaadaabcbdbbcbcc	TRUE
bbacacbacdaccadccbdcbb	TRUE
daddadaccdbdcdbdccbcccb	TRUE
dbddddbbabcdaabddcbcbcbdb	TRUE
dcadccdda	TRUE
dbdadbbcdccbddcdccdddcdbd	TRUE
bdcddadadabdcddcaabc	TRUE
caadcdaaaabdaaadbbcdbcbcd	TRUE
cacdbbbdbbdbcbdccdd	TRUE
bbacacbacdaccadccbdcbbb	TRUE
bdbadadaacdccccbb	TRUE
ccaadddaaababb	TRUE
cc	TRUE
cc	TRUE
ccdbdcdbadcdcacacdbcaadbd	TRUE
ababddbcdcbbbcdbbcd	TRUE
ddacaacddcbbcbccdbdbdbcdd	TRUE
cdbbddbbabdac	TRUE
adccbcbbb	TRUE
dbbdddddbac	TRUE
cbcdba	TRUE
dcdaccacaadbbdcddcdbddbc	TRUE
daabcbdbbcbcc	TRUE
ccbdbb	TRUE
bcdaabbdb	TRUE
caaccaadddaaaba	TRUE
cdbbdaadcaaaacaccadbdadb	TRUE
ccdbbdaadcaaaacaccab	TRUE
daabcbdbbbc	TRUE
cabdbddcdbddbb	TRUE
baa	TRUE
daabcbbcc	TRUE
cbdbcdddb	TRUE
daddadaccb	TRUE
bcbcc	TRUE
aacbcccdbccdcccbdbb	TRUE
adbbdcdbddc	TRUE
cacbab	TRUE
bdbcdddbabddaadbbddcbbdcb	TRUE
cacbacdaccad	TRUE
adccddacba	TRUE
dbbcdcdcadc	TRUE
cdacacdbbdcbccdbbddd	TRUE
acabdbddcdbddbb	TRUE
dbddcbba	TRUE
cabddcd	TRUE
ddadaccdbdda	TRUE
acdccccabbb	TRUE
bcacdacacdbbdcbccdbbdddb	TRUE
accaadddaaabaacbd	TRUE
ccdbdcdbadcdcaca	TRUE
ccacdcbbccbbddbbddb	TRUE
ddcbdbabadcbdbbbbcdbdbb	TRUE
dbbddbbabda	TRUE
cdaadcdaccacabda	TRUE
dcdbdcdaddadbac	TRUE
ccadccb	TRUE
bddaabbcb	TRUE
ccbdbcdddbabddaadbbddbc	TRUE
ddcacaaccaadddaaaba	TRUE
dbbddbbabdaccadabbbd	TRUE
ddadaccdbdcdbdccb	TRUE
baccabdab	TRUE
ccdadbbcbccccb	TRUE
ababddbcdcbbbcdbbcddc	TRUE
daabcbdb	TRUE
accddd	TRUE
acdbbbb	TRUE
ccbaccabdabdcbdbdcdcdbbc	TRUE
acdbbbdbbdbcbdccccdbddbd	TRUE
bbadaabbdcbbcbbbdbcccbdcb	TRUE
cbaccabdabdcbdbdcdcdbbc	TRUE
bdaccaaab	TRUE
ccbaccbb	TRUE
dbdbbbdbcaadadacdddaaaaca	TRUE
ccbbdcdbbcdbdadbdabdcccbc	TRUE
acabddcbb	TRUE
bcc	TRUE
dbadcdcacacdbcaadabd	TRUE
cbaccabdabdcbdbdcdcd	TRUE
dccbcbbdcbbac	TRUE
adccddaccddabcddaadbb	TRUE
ccacaadbbdcd	TRUE
dcd	TRUE
bdadbcbdddcdcccbbbccbbccc	TRUE
accacdcbbccbbddbbd	TRUE
cddcacaaccaadddaaabaa	TRUE
ccacaadbbdcddcdbddbcc	TRUE
bacdaccadccbcbbb	TRUE
ccacdcbbccbbddbd	TRUE
bddbcb	TRUE
daddadaccdbdda	TRUE
dccccabbbbbbcdbbccbcddbc	TRUE
dbaacabdbb	TRUE
dcbdddcccbdbcbac	TRUE
ddabcddaadbb	TRUE
ccabbbbbb	TRUE
dbabcbcddbbdcbbcdcbbccb	TRUE
bccdaddccbbddcbdcbbdb	TRUE
ac	TRUE
dbdabccdaddccbdddcbdbb	TRUE
dbaddbcdbcccdbdcbbbcdcbbd	TRUE
ccdcbdddcccbdb	TRUE
abb	TRUE
cbbb	TRUE
dddabadcadbdcbddddddcbdcc	TRUE
dbac	TRUE
ccabbbbbbcbcdb	TRUE
da	TRUE
acdbbbdbbdbcbdccc	TRUE
dcdcdbdcdaddadaccdbd	TRUE
dadbbcbccccbc	TRUE
bdaccaad	TRUE
aaaacaccadbdcabcbdbcb	TRUE
dbbd	TRUE
bdaccadabdbddbdcddcbddcbb	TRUE
ddccbcdaacbdcdbcbdbcdcddb	TRUE
dbadcdcacacdbcaadb	TRUE
bbacacbacdacc	TRUE
ddcccdadbbcbcccd	TRUE
cbccbbabaadcbccdddccdbccb	TRUE
dbbcdd	TRUE
cbdbcdddbabddaadbbddcbbd	TRUE
dccccabbbbbb	TRUE
bddaabdb	TRUE
bcadbb	TRUE
bcdbaacabddcdadbbc	TRUE
aadabbddbbbcbbddccb	TRUE
bcdabb	TRUE
dbcbcdabbb	TRUE
ddaccddabcddaada	TRUE
bbbcbdcddadadabdca	TRUE
bdbcdddbaba	TRUE
ccb	TRUE
dbcaadabbddbbbcbbddccdd	TRUE
bdababbdbdcdcdbddccbc	TRUE
ddbcbcdcabbbbbcb	TRUE
dca	TRUE
bdcddcaaccdcbdddccadb	TRUE
ddcaaccbc	TRUE
dbddcbbacacbacd	TRUE
dccbcbbddc	TRUE
cdcbcdbbcbbddcbdbba	TRUE
ba	TRUE
ba	TRUE
bd	TRUE
cbdbbbbcdacdbabbccbcbb	TRUE
dcdbdcdaddadaccdbd	TRUE
caadbbdcddcdbddbccbbcbdcb	TRUE
dd	TRUE
cad	TRUE
cddabcddaadaabcddb	TRUE
bdadd	TRUE
ddaccddabca	TRUE
cbcbbdcbbaca	TRUE
abcabbcdbb	TRUE
cdbbddbbbc	TRUE
abcabbcddbcdcbbbc	TRUE
cbaccabdabdcbbb	TRUE
cdbabcbcbbdcddcbccbbcddbc	TRUE
abcbdbbcbcccbbbdcdcdbc	TRUE
baccabdabdcb	TRUE
dbbdddddbaccb	TRUE
ddcacaaccaadddaaabaacd	TRUE
acbacdaccadccbddd	TRUE
adcdaccacaadbbdcd	TRUE
ddadadabda	TRUE
cdaadcdaccaada	TRUE
dbbdb	TRUE
daaccacdcbbccbbddbbddb	TRUE
cdadbbb	TRUE
babcaaa	TRUE
accdcbdddcc	TRUE
bdaddbcbddcbbdbbdbbdccbd	TRUE
dcabbbbdbbdccbdcbbddbcdbb	TRUE
dadaacdccccabbbbbbcdb	TRUE
ddadadabdca	TRUE
bbacacdbbbdbbdbcbdccdd	TRUE
bbacacbacdaccadccb	TRUE
dccccabbbbbbcdbbccbcdbb	TRUE
cccad	TRUE
acabddcdadbbccbdbdb	TRUE
dcdcadccddaccddabcddaada	TRUE
bcb	TRUE
dcaab	TRUE
daddadaccba	TRUE
aadbaadaddbbdccbdcdcdcdcb	TRUE
adbbddcbbdcb	TRUE
baccabdabdcbdbdc	TRUE
abcabbcdd	TRUE
accdb	TRUE
cabdbddddbcc	TRUE
adabdbddbdcdb	TRUE
acabddcdadbbccbdb	TRUE
dbcaadabbddbbbcb	TRUE
acb	TRUE
c	TRUE
c	TRUE
c	TRUE
c	TRUE
c	TRUE
c	TRUE
c	TRUE
c	TRUE
c	TRUE
c	TRUE
c	TRUE
c	TRUE
c	TRUE
c	TRUE
c	TRUE
dadbaacabccddddbcc	TRUE
acdbbbdbbdbcbdc	TRUE
adaaba	TRUE
acdddbdabbddbcbbbdbcdbd	TRUE
ccdadbbcbccccbcdddcd	TRUE
aabaacdcbdddbbcbdd	TRUE
cdbb	TRUE
dcdcadccddaccddab	TRUE
bbdcbb	TRUE
dbcc	TRUE
ddcaaccdcbdddcabb	TRUE
bcdaabbdcdb	TRUE
dbaacabdbddcdcbbbbdbccbbc	TRUE
dc	TRUE
bbcdadbaacabccddddbcc	TRUE
ccba	TRUE
cacdbbbb	TRUE
ddabcdd	TRUE
acda	TRUE
cbdbcdddbabddaadbbbc	TRUE
daacdccc	TRUE
dadbbcbccccbcdddcdcddd	TRUE
caaba	TRUE
bdcddaba	TRUE
abcacdacacdbcdcbccd	TRUE
daddccbbddcbdcbbdbdbdbdb	TRUE
ddadadabdcddcaaccbc	TRUE
ccacaadbbdcddcdbdd	TRUE
ccbdbcdddb	TRUE
aadddaaabaacdcbddbbcddc	TRUE
aacdcadcbdabbcdbcbbddbccc	TRUE
dbba	TRUE
abbdcdbddcccbdbcc	TRUE
dcdcadccddaccddabcddaadbb	TRUE
cbcccdbbdaadcaaaacacbb	TRUE
aaccaadddaaabaacdcbddbdd	TRUE
ddadad	TRUE
dcdcadccddac	TRUE
cabddcdaabd	TRUE
bdaddbcbddcbbdbbbd	TRUE
dacddcbaccbccbcdbbcbcbdbb	TRUE
abbbdbccddbcddbbdbddbdddc	TRUE
dbdcdbadcdcacacdbcaad	TRUE
cdaadcdaccacaadbbdcd	TRUE
cddabb	TRUE
dbbdddddbaccbaccb	TRUE
dacdbabbccddbbdcbbcdcbbc	TRUE
dacacdbcdbccdbbdbcbdcbdbc	TRUE
accdcdcabddbdbbdbbdccddbb	TRUE
dcabbbbdbbdccbdcbbddd	TRUE
dcdcadccddaccddabcddaad	TRUE
cbdbcdb	TRUE
bacacdacdbaacdbbdbbbdcddc	TRUE
ccdbd	TRUE
bdcddcaaccddd	TRUE
aaab	TRUE
bbdaddbddbbdcbbdddbbbbb	TRUE
cabdab	TRUE
dbaacabdbddcdcbbbdbbbb	TRUE
bcadbbdcdb	TRUE
cadccb	TRUE
ddadadabdcddca	TRUE
acc	TRUE
dabdabcbbbbdbccbbcbcdb	TRUE
daacdccccabbbbbbcdb	TRUE
cab	TRUE
cab	TRUE
dbbac	TRUE
bcbc	TRUE
bdbabadcbdbbbbcdbdbbcbcdc	TRUE
ccdadbbcbccccbc	TRUE
cabdbb	TRUE
dcbb	TRUE
ccddabca	TRUE
cbaca	TRUE
dbadcdcacacdbcaadabddd	TRUE
acddb	TRUE
acdbcaadabd	TRUE
bdcddadadabdcddcaaccbc	TRUE
aaba	TRUE
ab	TRUE
ab	TRUE
ab	TRUE
ccbdbcdddbaba	TRUE
ccbdbcdb	TRUE
dadcdaaccacdcbbcb	TRUE
bbdcbba	TRUE
ccabbbbbbcdbb	TRUE
daacdccccabbbbbbcdbbcc	TRUE
bcdabbb	TRUE
adabdbddbdcd	TRUE
acabddcdadbbc	TRUE
bdbabadcbdbbbbcdb	TRUE
cbacdaccadcabb	TRUE
cacbacdaccb	TRUE
acdccccbbb	TRUE
cdddbdabdcdabbbbddb	TRUE
cccabbbbbbcdbbcc	TRUE
ddadadabdcdd	TRUE
cacbacdac	TRUE
cdaccadccbcbbbdcbccc	TRUE
dbbddbbabdac	TRUE
bcdcabbbbdbbdccbdcbb	TRUE
bdbcdddbabdd	TRUE
dccddac	TRUE
ddadadabdcddcaaccdcbbcb	TRUE
ccabdabdcbdbdcdcdb	TRUE
cbaccabdab	TRUE
ccdadbbcbccccbcdddc	TRUE
cdb	TRUE
cdb	TRUE
bbacacdbbbdbbdbc	TRUE
badcbbbbbbcdbdbb	TRUE
abdb	TRUE
bcbddaccbdbdddcdddbccbbbd	TRUE
bcdaabbd	TRUE
bbccddcacaaccaadddaa	TRUE
cbdbcdddbabddaabdcb	TRUE
cbaccabdabdcbdbdcdcdbd	TRUE
bbacacbbb	TRUE
baaabcabbdb	TRUE
bdbabcacddbbbcbbb	TRUE
cacbacdacc	TRUE
ddcaabc	TRUE
baaabcabbcddbcdcbbbcdbbcd	TRUE
cacdbbbdbbdbcbdccccdbbd	TRUE
adaabcb	TRUE
aacbcccdbccdcccbdbbcddc	TRUE
a	TRUE
a	TRUE
a	TRUE
a	TRUE
a	TRUE
a	TRUE
a	TRUE
a	TRUE
a	TRUE
a	TRUE
a	TRUE
aaccdcbdddccadb	TRUE
dcadccdd	TRUE
dcbcdbbcbbddcbdaddbcb	TRUE
acbacdac	TRUE
ccdadbbcb	TRUE
dcdcc	TRUE
dbbaddcccdab	TRUE
ddadadabdcddcaac	TRUE
acdcbbccbbddbdbbbdddd	TRUE
cacdbcaadabdddbbbcbbddcc	TRUE
cadabdbddbd	TRUE
bcbaccbcdbdbdbdb	TRUE
dccccabbbbbbcdbbccbc	TRUE
bcdbaacabddcdadbbccbdbdbb	TRUE
dbcb	TRUE
cdbcaadabbddbbb	TRUE
aacddcbbcbccdbdbdbcdddbb	TRUE
bcbbdcbbaca	TRUE
ccbcdba	TRUE
bddaadbbbc	TRUE
ddabcddaadaabcddbbbc	TRUE
abdbddcdcbbbbdbb	TRUE
bbacacbacdaccadccbdcbbdd	TRUE
daabcbdbbcbccc	TRUE
cddcddabcdacccdbbbccbbcbd	TRUE
bdbabadcbdbbbbc	TRUE
bddaadbbddcbbdcbdcbbc	TRUE
daabbdcdbddccdb	TRUE
aadddaaabaacdbbb	TRUE
dcdcacacdbbcb	TRUE
cabbbbbbcdbbcdd	TRUE
bcbaccbcdbcbbbdcdcddbdbc	TRUE
ccadabdbddbdcddcbd	TRUE
baccabd	TRUE
aaccdcbddd	TRUE
bcdbaadd	TRUE
dccdda	TRUE
babcadbcdcdbddccb	TRUE
bbbbb	TRUE
ccad	TRUE
bdaddbcbddcbbbcbd	TRUE
baccabdabdcbbb	TRUE
dbdcabbbdbccddbcddbbdbd	TRUE
baccabdabdcbdbdcdcd	TRUE
bcdaabbdcdbbd	TRUE
dbadcdcaca	TRUE
badcdcdbdcdaddad	TRUE
ccbdc	TRUE
cadabdbddbdcdb	TRUE
badcdcdbdcdaddadaccdbb	TRUE
dadcdaaccacdcbbcdbbd	TRUE
bdcbc	TRUE
cabbbcbaaabcbad	FALSE
accbcbccbcbcdddbdbacdccab	FALSE
bddaadbbdddddbacb	FALSE
cdbbddbbabdaccadabada	FALSE
cadccbcbbdcbbacacdbbdb	FALSE
bcbabba	FALSE
daabcbaccbcdbaacbdd	FALSE
cdbdcdbadcdcacacdbcaabaa	FALSE
cdccccabbbcbaaabcababad	FALSE
dddaaabaacdcbcba	FALSE
ccdadbbcdcdcadc	FALSE
cacbacdaccadccbcbbdda	FALSE
cabddcbba	FALSE
abdbadb	FALSE
cdacbba	FALSE
dabbbdbbbadadbacdcaadacca	FALSE
ccacdcbbdcddcbada	FALSE
ccdbbdaadcaaaacaccadbba	FALSE
ccccbaaabacdacbbdaabbacda	FALSE
cddabcdba	FALSE
dadbddcbbacacbacdacc	FALSE
dcadccddaccddabcdba	FALSE
bbacaaadacdbbaaddbbdcbbbb	FALSE
ddadadabdcddcaaccdbca	FALSE
cabcacdacacdbbaaacb	FALSE
ccdabbac	FALSE
dabdabaccdaadcdac	FALSE
dabdabaccdaadcdacc	FALSE
dcdadbba	FALSE
dabdbadadaacdcccbb	FALSE
bbacacbacdaccadcbba	FALSE
cbaccabdababcadbbaddc	FALSE
cccacbbadcacacacacbabdbbb	FALSE
dadbabcdadbcbcbadcbbcabbb	FALSE
cacbabab	FALSE
abdababcadbbadd	FALSE
cbbcdcdadccadccabadbaaaac	FALSE
daccacaadbbdcdcdadcdaa	FALSE
abbbcbaaabcababadcdcad	FALSE
ccabbbcbdaabdbccdccabbabd	FALSE
dbbdddddbaccbba	FALSE
bcbbdacdcbabcccabdabaddda	FALSE
bddaadbbddddda	FALSE
accacccdddaabbcbabaccddcc	FALSE
bdcdbbbdcbddcbbdaccababad	FALSE
cdcacbbaaadadccdcdbbccaab	FALSE
bbcaddddcadabbbbadbcbadab	FALSE
acaccdacbddcbccabddbdaadb	FALSE
cbccdbbbccbdcadbbdbaadbdc	FALSE
dabaacbcccdbbcccbbaaadcba	FALSE
ddbcbcdcabbdaddbddbacabc	FALSE
cabcaadcabdadabaabdbbccab	FALSE
acdccccabba	FALSE
cddabcddaadaabcbac	FALSE
babadcdcdbdca	FALSE
babadcdcdbdbac	FALSE
cabdbabcabb	FALSE
cdbcaadabbcdaa	FALSE
dabdbadada	FALSE
acdcbbdcdaca	FALSE
cabdababcadbbaddcccd	FALSE
bddacbdcddddcbabaabdabbdb	FALSE
acdddbdabdada	FALSE
bddcdddbcbcacdcacddddbbba	FALSE
dadabdcba	FALSE
cacdbcaadabbcdadba	FALSE
bcabba	FALSE
cabdbabc	FALSE
caaccaadddaaabaacdba	FALSE
cdbcaadabbcdadbaacbb	FALSE
daabcbaccbcdbaacabdba	FALSE
dbaaccccdbbbaacbcdddadacc	FALSE
baccabdba	FALSE
abdbabcacdddbdabd	FALSE
ddabba	FALSE
aacacdbaddbbbcacbabaabdaa	FALSE
acdcbbdcddcbdbabad	FALSE
dbaacabbba	FALSE
cccabccdcbdcbababbbabddab	FALSE
cbabba	FALSE
bccdaddccbbcdbcbcbda	FALSE
bcbdccabadabdccacddacabac	FALSE
bddabbbbbcdbabddabbcdaccc	FALSE
aaccbdbac	FALSE
dcadccbba	FALSE
addabdbcbbbcacacddcdcdcaa	FALSE
accacdcbbdcddcbdbbba	FALSE
dadaacdccccabbbca	FALSE
abdbabcacdddbdabdcdabdab	FALSE
cdababa	FALSE
bbddbcdbdabccdaddccbbba	FALSE
bcddaadaabcbaccbcdbaac	FALSE
dadbaacbba	FALSE
dcbbccddcacaaccaaddabba	FALSE
abcabab	FALSE
cdccccabba	FALSE
bcdbbcbbddcbdaddbcbcdad	FALSE
bddaadbbdddddbaccb	FALSE
baacdcbcdbbadcbba	FALSE
ccbdbcdddbabddaadbbdba	FALSE
dcdaaccacdcbbdcddcbdbab	FALSE
bcadbbaddcc	FALSE
daabbbcbdcddaba	FALSE
daabcbaccbcdb	FALSE
ddaccddabcdba	FALSE
ddcccdadbbcab	FALSE
adcbdacddabbaaadacbabdcdc	FALSE
dcadccddaccddabcddaadaba	FALSE
dadbaacababd	FALSE
abbac	FALSE
dcddccdbaabcdadbdabdccada	FALSE
baacccbdcbdbbddbbaccaadca	FALSE
acabddcdadbda	FALSE
abbbcdacdbccddbbcaacddbaa	FALSE
aaacaccadbdcabbddbcdbdab	FALSE
acabddcdbba	FALSE
bbccbacaadbcadaacaacadaba	FALSE
cacbacba	FALSE
cbacdaccadccbcbbdcbbacbb	FALSE
dcddcccdcacccdccddbadddba	FALSE
bcbbdcbbacacbbba	FALSE
bdbcdddbabddaaaccba	FALSE
cdbaabaccbcaaabdcaabbdadd	FALSE
dabddcba	FALSE
abddcdadbdba	FALSE
dddbddcabcdaabcbdabdbddbc	FALSE
bcdbaacabddcdadbda	FALSE
daabcbaccbcdbaacabdd	FALSE
cdcbabba	FALSE
dcacacdbcaadabbcdadbaac	FALSE
adbbcbabbaddbdbcbcbabdccb	FALSE
cbaadacdaadcaaddaddbadaba	FALSE
cacdbbddbbabdacbb	FALSE
dcdcbabbac	FALSE
acdccccbaaba	FALSE
acdbbdbbbbdaaacbcccaad	FALSE
dbddcbbacabbca	FALSE
bbabba	FALSE
bbabba	FALSE
bbabba	FALSE
bbabba	FALSE
ccdbcbcbbcaabdddcbcdbccaa	FALSE
cdbcaadabbcdadbaacabb	FALSE
ccbcdbaacabddaba	FALSE
ccbaccabdababc	FALSE
dbcaabddbcbaaabaabbabdaab	FALSE
dadbbcdcdba	FALSE
ddcccdabba	FALSE
cdccccabbbcbaaabcabab	FALSE
cddcacaaccaadddaaababcba	FALSE
dcaabbccdddcdaabdddadbbcb	FALSE
dcabbdaddbddbacabcacd	FALSE
bcbbabba	FALSE
bbbcbabba	FALSE
acbbbaadabbdbcacddccbdcba	FALSE
cdacacdbbdbbbbdaaacbccab	FALSE
cbabdbacacaaacdccadabdcbc	FALSE
adbbdba	FALSE
cbdabbbbdaadddaaabccbabba	FALSE
bbaddabdcaddddbaadbbbcaac	FALSE
bbbcbdcddadadababa	FALSE
caadbbdcdcdadcdaac	FALSE
bcabbcbddbcaaadbacbbaabab	FALSE
ccbaccabdababcadbbaddc	FALSE
aaddaccbaccbdababdabbdbda	FALSE
bddaadbbdba	FALSE
bdcddcaaccdcbdba	FALSE
cadcbcba	FALSE
daadbdccbcaacccabdbbcdcaa	FALSE
adabdbadadaacdcc	FALSE
acbdcdbcdabcbadbccdabdcab	FALSE
cddcacaaccaadddaabbabb	FALSE
ccdadbbca	FALSE
acdcbbdcddcbdbab	FALSE
aadacdadbdcccdacbdcacbdcb	FALSE
adbcbbbbbbdbdbccbbdaddcbd	FALSE
babcba	FALSE
abacdbbbcbbdccdaabdbabbab	FALSE
cddcacaaccaaddbba	FALSE
adcabbcbacdddaacaabdacbbc	FALSE
acdddbdabdcdabdb	FALSE
dacbba	FALSE
ddcccdadbbcdcdba	FALSE
dbbcbbddcbdaddbcbcda	FALSE
adcbbbdbdbcdbbbcacadbddda	FALSE
cbacdacbba	FALSE
ddadadabdcddcaaccbda	FALSE
cddabbcbcaadaccbdadadbbaa	FALSE
cddabcddaadaabca	FALSE
ccbdbcdddbabddaadbbddba	FALSE
bdcbcaadcdaccbbbdadcbcaba	FALSE
ccdbabba	FALSE
bdcddadadabdcddcaacbda	FALSE
aacadcdaabcbdddddbdabadbd	FALSE
dcacddbbbbccaadbacadbbaab	FALSE
dadbaacabdbabca	FALSE
cdaadcdaccacbbac	FALSE
dcbcdbbcbbddcbdaddbba	FALSE
bcdddbdbdaabacccdbcadbcad	FALSE
baccbcdbaacabddcdadbddbc	FALSE
babdadccadcbdabbbbdddcdac	FALSE
dcdbdcdaddadaccdbdcdbad	FALSE
cdaddccbbcdbcbcbddacba	FALSE
bcacdbacccbcacacaddbbaabb	FALSE
aadabbcdadbaacabdbabca	FALSE
dddbdabdcdabdab	FALSE
bcadcbbbbdbccabaabbdacddb	FALSE
bbdadbbdabbabcabdbacbbbac	FALSE
adbbdcbaaddbadcdbacacadcd	FALSE
dbababa	FALSE
abcbaccbcdbaadd	FALSE
badacabcaaabcccbacdabdbba	FALSE
bcabbba	FALSE
dcaaddacdbbcbbdcbcaacabac	FALSE
accacdcbbdcddcbdbabadcbb	FALSE
cddabcddaba	FALSE
acdccbcba	FALSE
bccadadcdcababcbdbddbacab	FALSE
dacdbabcbbbabcdccdbdadda	FALSE
adacadbacddccadbbdbadbccc	FALSE
ddadaccdbdcdbad	FALSE
bdbcbdabba	FALSE
bdcbccccaddadacdbbaabdcac	FALSE
acbacdaccadccbabb	FALSE
bbbabba	FALSE
abddba	FALSE
bdbcdddbabddaadbbddba	FALSE
ccbaccabdba	FALSE
acddacacdbbaaccdbbdcbabbb	FALSE
cacdbcaadaba	FALSE
dbbdddaccbdbdbcbbbcbcbdca	FALSE
aaacaccadbdcabbddbcab	FALSE
aaaabbadcaaddaabdabdcbcac	FALSE
dbbddbbabba	FALSE
cdabba	FALSE
acdbbddbbabdacc	FALSE
daacbbdbddcccdbcbabdadcbd	FALSE
cdcbdddadbba	FALSE
cabacbdccddddabddacabcacd	FALSE
acdddbdabdcdabdabac	FALSE
aacbabaacaaadcddadcdbbaab	FALSE
adbbdddddbacb	FALSE
dadabdcddcba	FALSE
dccbcbbdcabba	FALSE
ddadaccdbdcdbadcdcac	FALSE
ccbaccbbab	FALSE
dcdbdcdaddadaccbbac	FALSE
dddabba	FALSE
cdacbcadaadcbdaaabccbdaaa	FALSE
daccdbdcdbadcdcac	FALSE
baaabcabab	FALSE
cdbbddbbabdaccadabdbadb	FALSE
cdaddccbbcdbcbcbddabd	FALSE
ddadaccdbdcba	FALSE
dcdbabba	FALSE
cdbcababa	FALSE
bdbabcbba	FALSE
dcaccbaadbabbcaacbddabadb	FALSE
dcacacdbcaadaba	FALSE
dcddbcacbdcacbbaaddbabbab	FALSE
cabbda	FALSE
aadadaaccabbcbccaddcbcdda	FALSE
dcbdddadbba	FALSE
ccabbbca	FALSE
ccbdbcdddbabbdda	FALSE
cdbcaadbba	FALSE
bdaccadabdbadadaacdcccbb	FALSE
cbcdbaacabddcdadbddcbba	FALSE
ccaadddaabbabb	FALSE
bbbcbdcddabcba	FALSE
bcdcabbdaddbddbacabcab	FALSE
ccdaadcdaccacaadbbdcdca	FALSE
ccabdababcadbbaddc	FALSE
aabcabab	FALSE
cabdababcadbbaddc	FALSE
aabaadbbcdaacbdbcbabbbcbb	FALSE
ddadadabdcddcaaccdcbdda	FALSE
ccabbbcbaaabc	FALSE
aabadabbababbdcbadaddcabc	FALSE
ccacdcbbdcddcbdbabada	FALSE
ddadaccbbac	FALSE
cdbdcdbadbba	FALSE
ddbabacdabcdcddbbaadccdbd	FALSE
bdcdabdabacb	FALSE
bdbabadcbbccddcacaa	FALSE
aabcababadcdcdbdcd	FALSE
bddcdadbddcbbacacbacda	FALSE
caaccaadddaabba	FALSE
bdaddbcbcdcabbba	FALSE
ddddbdcdcacbabbcdacaadcbb	FALSE
bdbabcacdddbdabdcdabdab	FALSE
addbadcbbbbacaadacdcaaddb	FALSE
cdaddccbbcdbcbcbddaccbbb	FALSE
aacbadacbccdddbddbabdadbb	FALSE
bdddcccbbabba	FALSE
cabdababcadbb	FALSE
aaccdcbdddccbba	FALSE
babadcdcdbab	FALSE
daadcdaccacaadbbdca	FALSE
ccbaccabdababcab	FALSE
bdaccadabdbadadaacdccc	FALSE
dadabdcddcaaccdcbac	FALSE
acaadbbdcdcdadcda	FALSE
ddadaccdbdcdbadcdc	FALSE
cabba	FALSE
cabba	FALSE
cabba	FALSE
cabba	FALSE
dbadcbbbbddddccbaaddcbdda	FALSE
abcbab	FALSE
cabdbabcacdddbdabd	FALSE
dcdcacacdbaba	FALSE
bbbabacdacadaacbdbcaabbbb	FALSE
dadcdaaccacdcbbdcda	FALSE
bbacacbacdaccaba	FALSE
aabbab	FALSE
daddbba	FALSE
bababa	FALSE
ddbbcaccdbbddbbbddcadadab	FALSE
dcbbccddcacaabba	FALSE
cabdba	FALSE
aabaacdcbcdbbcbbda	FALSE
ccabbbcbaaabcababad	FALSE
abbbcbdcddadadabd	FALSE
ccdaadcdaccbbad	FALSE
bbacbba	FALSE
aacdbbabbcdddaddbdababdac	FALSE
cbcbddaadaddccacccbdbaacb	FALSE
acbacdaccaba	FALSE
cccabbbcbaaabc	FALSE
cbcdbcdacbdaabcdbdcdbbadc	FALSE
bcbaccbcdbaa	FALSE
adabdbadadaacd	FALSE
cadbcbbacbacdaadbaababbdb	FALSE
bbdcbbacacbbba	FALSE
caadddaaabaacdcbcba	FALSE
cabdababcadbbaddcdd	FALSE
ccbabba	FALSE
dccbcbbdcbbacacbabab	FALSE
adbdcaaccadcbaadcdcccbbbb	FALSE
bdabddaddaaadbdbdabcaabdc	FALSE
adcdaccacaadbbdcdcad	FALSE
cdcbdddcccbdbcdddbabbdda	FALSE
bdcdabdba	FALSE
dcdcadccddbbab	FALSE
cdddbdabdcdabdabaccd	FALSE
ccdbbdaadcaaaacbbab	FALSE
cacdbbdbbbbdaaacbccab	FALSE
ccbaabba	FALSE
dcdaccacbbac	FALSE
cbcbbdabba	FALSE
cbbabba	FALSE
dacbcaacacdbdbabddbccaaca	FALSE
caccbbbabbbbccbdcaccccbcb	FALSE
cbabbdda	FALSE
bdbdbcbdbddbbcbbbbbdaabba	FALSE
acdbbddbbabdaccaaab	FALSE
abbdaadcadaaadabcbdddacab	FALSE
ccdaadbba	FALSE
ccdaadcdaccacaadbbdcdcad	FALSE
bbacacbacdaba	FALSE
dacddcabcdbbaddbdccbaabbb	FALSE
bbdaddcbcdabdcbaddbdcccdb	FALSE
dbddcbbacacbaba	FALSE
abcbaccbcdb	FALSE
bbccddcacaaccaabba	FALSE
dbbabba	FALSE
babccdcddbdcbbcabacbdabdb	FALSE
daabbbcbdda	FALSE
baabbbcaadbccaabdbbbcdda	FALSE
cdadbbcdcdcadccdda	FALSE
cbacdaccbba	FALSE
dabdbadadaacdcc	FALSE
cdadbbcdcdcadccddacba	FALSE
acdbbdbacc	FALSE
bddaadbbddba	FALSE
cdddbdabdcdabdabaccda	FALSE
bbcdadbaacabdbab	FALSE
acabba	FALSE
bcbbdcbabba	FALSE
baacabbdccaadbaaabdbacaab	FALSE
daacacabbdacaddddcacbbcba	FALSE
dabdcddcaacba	FALSE
abbad	FALSE
badacdddaccdaccdbcaadacba	FALSE
baddcaaaaadcbacccbacdcbcb	FALSE
dcdaccacaadbbdcdcdadb	FALSE
ccbaccabdababcadbbaddcdd	FALSE
dcdaaccacdbbbba	FALSE
bddaccbdbbbbcdacdbababd	FALSE
aacaddccdcdcaadbdbaccbbbb	FALSE
acbacdaccadccbcbbdcbbac	FALSE
daabcbaccb	FALSE
cdcbababddbccccccadcabcdb	FALSE
cbdbcdddbabddaaaccba	FALSE
cabbbcbaaabcabab	FALSE
adbba	FALSE
bbdbaacadcbbcbdcdbabccabb	FALSE
ddadaccdbdcdbadcdcacab	FALSE
bcdaabbbcbdda	FALSE
aabcababadcdcdbdb	FALSE
dddbdabdcdabdabaccdaad	FALSE
bccabdbdddabdcccabddcddbc	FALSE
dcadccddbbab	FALSE
daabcbada	FALSE
cdabcba	FALSE
cdabcba	FALSE
cbaccabdababcadbbaddcdd	FALSE
aaadacdadacbcbcaaadcddbbb	FALSE
aaccabaacdcdcacbdbcbddaad	FALSE
abcababad	FALSE
ddbddbacabcacdacacaaaba	FALSE
ccabbbcbaaabcababaad	FALSE
ccddabcddaadaabca	FALSE
aacadadacdbcddaabadcadbcb	FALSE
bccdaddccbbcdbabcda	FALSE
bbacacbacdaccadcba	FALSE
baaabcabbad	FALSE
badccbcbabdcccbbdabbbdaba	FALSE
cabdbabcacddbd	FALSE
adabdbadadaab	FALSE
dabdcddcaba	FALSE
bcbaccbcdbaadd	FALSE
badcbbccddcaca	FALSE
dbcbcabbba	FALSE
aaaacaccadbdcabbddbcab	FALSE
abccdaadbdaaaaaaccabaadad	FALSE
adabdaaddabddcacbcbcdabaa	FALSE
dcdcadcbba	FALSE
dcdcdbdcdaddadaccbbac	FALSE
dabba	FALSE
dabba	FALSE
dabba	FALSE
dcdacbddcccbddaadbdcdcbdd	FALSE
cdbcaadbdba	FALSE
caaccaaddbba	FALSE
cdbbddbbabdba	FALSE
cdbcaadabbcdadbaaab	FALSE
ccbcdbaacabddcbba	FALSE
dccdcabddacadddabddadbaba	FALSE
cbaccabdabab	FALSE
ddcaacdbba	FALSE
bdaddbcbcdcabbdadbb	FALSE
bdabaccdaadcba	FALSE
dcadccddaccddabcddaaaba	FALSE
dbbcdcdcadccddacdbba	FALSE
dcdabba	FALSE
abdba	FALSE
bdbbbcbdabdbbaabaddacdbab	FALSE
cdadbbcdcdcadccdd	FALSE
cddcacaaccaadddaaabba	FALSE
ddcaaccdcbdddcbba	FALSE
aaccdcbdddcbba	FALSE
dccdbcabcdbdadcbcbbbbbbab	FALSE
cdbcaadabbcdadbaa	FALSE
cdcbdddcccbdbcabba	FALSE
ccddabcdba	FALSE
aacddcbbdcabbaaadcaddaab	FALSE
aabcababadcdcdbdcdaddada	FALSE
cdddbabdba	FALSE
aabacbcbdcaacbbdcccbddabd	FALSE
dcdbabbac	FALSE
cdadbbcdcdcadccddaccdd	FALSE
cddcaccddbcdaacbcdcbadaaa	FALSE
abaddccbdcadcaadbcdbbbdcd	FALSE
cdbbdbbbbdaaacbccaba	FALSE
dbbaddcccdabba	FALSE
ccccbcaadbaabbdbabacaccaa	FALSE
adbbaddc	FALSE
acaccadbdcabbddbcdba	FALSE
adbbaddcccad	FALSE
bbdaddbddbacabcacdac	FALSE
ddbdbabba	FALSE
dbdcdbadcdcadbba	FALSE
dcadcbba	FALSE
bbdcbbacacdbbdbacc	FALSE
bdabaacddbdcdcbabbddababb	FALSE
dadbaacabdbab	FALSE
abacddbdbacacddacbadbdbbc	FALSE
accacdcbbdcdba	FALSE
bcbbabdbadad	FALSE
abcbaaaddaacbcadccaaadbbc	FALSE
cbcdccccdababbdcccdccadcb	FALSE
bcadbbadd	FALSE
dddbaaabdaadabbcdccaddadc	FALSE
cacdcbbdcddcbdbabadcbb	FALSE
cbccbaddbcdaccbcbcbaadbba	FALSE
dcdcdbdcdaddabba	FALSE
cadabdbadad	FALSE
ccadccbcbbdcbba	FALSE
dbcdaacddcabcbbdbcaabacbb	FALSE
bbcdabba	FALSE
cdadbbca	FALSE
aacbba	FALSE
ddaccddabcddaba	FALSE
bdbadabbabdcccddccdcacaba	FALSE
cdbabba	FALSE
acbacdaba	FALSE
cacaadbbdcdcad	FALSE
ddccacbcdcadaabbcccbaacab	FALSE
